短地: duǎn de
嘀地: dí de
蹬地: dēng de
突地: tū de
忽地: hū de
霍地: huò de
蓦地: mò de
倏地: shū de
墩地: dūn de
般地: bān de
嗖地: sōu de
尹地: yǐn de
咻地: xiū de
羞地: xiū de
腾地: téng de
傻地: shǎ de
气地: qì de
怯地: qiè de
全地: quán de
求地: qiú de
取地: qǔ de
轻地: qīng de
起地: qǐ de
球地: qiú de
强地: qiáng de
愀地: qiǎo de
确地: què de
猛地: měng de
河地: hé de
哼地: hēng de
流利地: liú lì de
锐利地: ruì lì de
热烈地: rè liè de
努力地: nǔ lì de
逆流地: nì liú de
偶然地: ǒu rán de
喃喃地: nán nán de
楞楞地: léng léng de
哀怜地: āi lián de
安乐地: ān lè de
爱怜地: ài lián de
冷冷地: lěng lěng de
恼怒地: nǎo nù de
安宁地: ān níng de
牢牢地: láo láo de
轮流地: lún liú de
俐落地: lì luò de
柔软地: róu ruǎn de
凌乱地: líng luàn de
恶劣地: è liè de
偶尔地: ǒu ěr de
仁爱地: rén ài de
伦理地: lún lǐ de
伶俐地: líng lì de
忍耐地: rěn nài de
扰乱地: rǎo luàn de
例如地: lì rú de
怜爱地: lián ài de
软弱地: ruǎn ruò de
剌耳地: lá ěr de
哀哀地: āi āi de
恼人地: nǎo rén de
柔韧地: róu rèn de
柔柔地: róu róu de
柔弱地: róu ruò de
浓浓地: nóng nóng de
耐劳地: nài láo de
容纳地: róng nà de
恋爱地: liàn ài de
朗朗地: lǎng lǎng de
难熬地: nán áo de
理论地: lǐ lùn de
傲然地: ào rán de
愕然地: è rán de
落泪地: luò lèi de
暖暖地: nuǎn nuǎn de
暗然地: àn rán de
溺爱地: nì ài de
懦弱地: nuò ruò de
狼狈地: láng bèi de
内部地: nèi bù de
二八地: èr bā de
二倍地: èr bèi de
让步地: ràng bù de
两边地: liǎng biān de
两倍地: liǎng bèi de
能变地: néng biàn de
难辨地: nán biàn de
额部地: é bù de
流畅地: liú chàng de
热忱地: rè chén de
仁慈地: rén cí de
屡次地: lǚ cì de
如常地: rú cháng de
热诚地: rè chéng de
冗长地: rǒng cháng de
日常地: rì cháng de
如刺地: rú cì de
两侧地: liǎng cè de
励磁地: lì cí de
连串地: lián chuàn de
临床地: lín chuáng de
恶臭地: è chòu de
潦草地: liáo cǎo de
露出地: lù chū de
露齿地: lù chǐ de
落地灯: luò de dēng
恶毒地: è dú de
冷淡地: lěng dàn de
能断地: néng duàn de
难得地: nán de de
懒惰地: lǎn duò de
连带地: lián dài de
虐待地: nüè dài de
逆动地: nì dòng de
唠叨地: láo dāo de
流动地: liú dòng de
难读地: nán dú de
难懂地: nán dǒng de
鲁钝地: lǔ dùn de
浪费地: làng fèi de
内行地: nèi háng de
爱抚地: ài fǔ de
安份地: ān fèn de
落后地: luò hòu de
厉害地: lì hài de
来回地: lái huí de
灵活地: líng huó de
软化地: ruǎn huà de
柔和地: róu hé de
浓厚地: nóng hòu de
历害地: lì hài de
如火地: rú huǒ de
良好地: liáng hǎo de
怒吠地: nù fèi de
柔滑地: róu huá de
逆风地: nì fēng de
偶发地: ǒu fā de
脸红地: liǎn hóng de
懊悔地: ào huǐ de
黏附地: nián fù de
难过地: nán guò de
乐观地: lè guān de
牢固地: láo gù de
爱国地: ài guó de
昂贵地: áng guì de
人工地: rén gōng de
肉感地: ròu gǎn de
连贯地: lián guàn de
能干地: néng gàn de
露骨地: lù gǔ de
廉价地: lián jià de
按级地: àn jí de
安静地: ān jìng de
内疚地: nèi jiù de
冷静地: lěng jìng de
宁静地: níng jìng de
立即地: lì jí de
冷峻地: lěng jùn de
利己地: lì jǐ de
连结地: lián jié de
拉紧地: lā jǐn de
耐久地: nài jiǔ de
难解地: nán jiě de
累积地: lěi jī de
拗口地: ào kǒu de
立刻地: lì kè de
冷酷地: lěng kù de
认可地: rèn kě de
热狂地: rè kuáng de
离口地: lí kǒu de
难看地: nán kàn de
难堪地: nán kān de
鲁莽地: lǔ mǎng de
暧昧地: ài mèi de
傲慢地: ào màn de
那么地: nà me de
浪漫地: làng màn de
暖昧地: nuǎn mèi de
礼貌地: lǐ mào de
如梦地: rú mèng de
冷漠地: lěng mò de
灵明地: líng míng de
灵敏地: líng mǐn de
怜悯地: lián mǐn de
浓密地: nóng mì de
匿名地: nì míng de
流氓地: liú máng de
联盟地: lián méng de
如泡地: rú pào de
罗盘地: luó pán de
融洽地: róng qià de
热切地: rè qiè de
哀求地: āi qiú de
灵巧地: líng qiǎo de
按期地: àn qī de
热情地: rè qíng de
如期地: rú qī de
年轻地: nián qīng de
离奇地: lí qí de
历史地: lì shǐ de
懒散地: lǎn sǎn de
类似地: lèi sì de
临时地: lín shí de
零散地: líng sǎn de
零碎地: líng suì de
凝神地: níng shén de
入时地: rù shí de
入神地: rù shén de
内省地: nèi xǐng de
认识地: rèn shí de
老式地: lǎo shì de
那是地: nà shì de
吝啬地: lìn sè de
拟声地: nǐ shēng de
来式地: lái shì de
罗嗦地: luó suo de
哀伤地: āi shāng de
按时地: àn shí de
柔顺地: róu shùn de
绕舌地: rào shé de
饶舌地: ráo shé de
爱睡地: ài shuì de
离散地: lí sàn de
勒索地: lè suǒ de
暗示地: àn shì de
碍事地: ài shì de
类推地: lèi tuī de
立体地: lì tǐ de
肉体地: ròu tǐ de
利他地: lì tā de
恶徒地: è tú de
爱他地: ài tā de
离题地: lí tí de
裸体地: luǒ tǐ de
邋塌地: lā tā de
邋遢地: lā tā de
露天地: lù tiān de
人为地: rén wéi de
安稳地: ān wěn de
略微地: lüè wēi de
安慰地: ān wèi de
热望地: rè wàng de
难忘地: nán wàng de
领悟地: lǐng wù de
理想地: lǐ xiǎng de
安闲地: ān xián de
轮休地: lún xiū de
安息地: ān xī de
安祥地: ān xiáng de
连续地: lián xù de
陆续地: lù xù de
女性地: nǚ xìng de
内向地: nèi xiàng de
任性地: rèn xìng de
安心地: ān xīn de
安详地: ān xiáng de
冷血地: lěng xuè de
冷笑地: lěng xiào de
逆向地: nì xiàng de
逆行地: nì xíng de
恶性地: è xìng de
流刑地: liú xíng de
难驯地: nán xùn de
难信地: nán xìn de
理性地: lǐ xìng de
矮小地: ǎi xiǎo de
零星地: líng xīng de
嶙峋地: lín xún de
恶意地: è yì de
乐意地: lè yì de
安逸地: ān yì de
扼要地: è yào de
人与地: rén yǔ de
任意地: rèn yì de
如意地: rú yì de
肉欲地: ròu yù de
灵验地: líng yàn de
浓郁地: nóng yù de
浓荫地: nóng yīn de
留意地: liú yì de
难驭地: nán yù de
安葬地: ān zàng de
冗赘地: rǒng zhuì de
认真地: rèn zhēn de
人造地: rén zào de
隆重地: lóng zhòng de
理智地: lǐ zhì de
论证地: lùn zhèng de
连载地: lián zǎi de
肮脏地: āng zāng de
恶兆地: è zhào de
捏造地: niē zào de
难治地: nán zhì de
率直地: shuài zhí de
累赘地: léi zhuì de
暗中地: àn zhōng de
不安地: bù ān de
卑劣地: bēi liè de
本能地: běn néng de
悲哀地: bēi āi de
必然地: bì rán de
便利地: biàn lì de
不宁地: bù níng de
不利地: bù lì de
不良地: bù liáng de
半路地: bàn lù de
本来地: běn lái de
白热地: bái rè de
冰冷地: bīng lěng de
卑陋地: bēi lòu de
波浪地: bō làng de
悖理地: bèi lǐ de
病理地: bìng lǐ de
博爱地: bó ài de
鄙劣地: bǐ liè de
暴乱地: bào luàn de
暴戾地: bào lì de
暴虐地: bào nüè de
暴烈地: bào liè de
白白地: bái bái de
不变地: bù biàn de
八倍地: bā bèi de
卜卜地: bo bo de
不便地: bù biàn de
百倍地: bǎi bèi de
卑鄙地: bēi bǐ de
背部地: bèi bù de
悲惨地: bēi cǎn de
不纯地: bù chún de
白痴地: bái chī de
不断地: bù duàn de
被动地: bèi dòng de
必定地: bì deng de
不动地: bù dòng de
不当地: bù dàng de
不定地: bù deng de
泊定地: pō deng de
表达地: biǎo dá de
背地地: bèi de de
摆动地: bǎi dòng de
部分地: bù fèn de
白话地: bái huà de
报复地: bào fù de
奔放地: bēn fàng de
败坏地: bài huài de
变坏地: biàn huài de
扁化地: biǎn huà de
跋扈地: bá hù de
暴风地: bào fēng de
爆发地: bào fā de
八股地: bā gǔ de
不顾地: bù gù de
不过地: bù guò de
不贵地: bù guì de
悲观地: bēi guān de
辩解地: biàn jiě de
悲剧地: bēi jù de
保浇地: bǎo jiāo de
卑贱地: bēi jiàn de
逼近地: bī jìn de
不敬地: bù jìng de
不假地: bù jiǎ de
不绝地: bù jué de
不洁地: bù jié de
不吉地: bù jí de
不均地: bù jūn de
不久地: bù jiǔ de
便捷地: biàn jié de
比较地: bǐ jiào de
不禁地: bù jīn de
不觉地: bù jué de
并肩地: bìng jiān de
不解地: bù jiě de
包括地: bāo kuò de
半开地: bàn kāi de
变快地: biàn kuài de
避开地: bì kāi de
不满地: bù mǎn de
避免地: bì miǎn de
不毛地: bù máo de
不灭地: bù miè de
表面地: biǎo miàn de
薄膜地: báo mó de
并排地: bìng pái de
被迫地: bèi pò de
不平地: bù píng de
不怕地: bù pà de
奔跑地: bēn pǎo de
扁平地: biǎn píng de
背叛地: bèi pàn de
薄片地: báo piàn de
薄皮地: báo pí de
不齐地: bù qí de
不屈地: bù qū de
抱歉地: bào qiàn de
变迁地: biàn qiān de
薄情地: bó qíng de
悲伤地: bēi shāng de
薄砂地: báo shā de
不时地: bù shí de
比色地: bǐ sè de
不少地: bù shǎo de
不实地: bù shí de
不衰地: bù shuāi de
不善地: bù shàn de
不慎地: bù shèn de
白送地: bái sòng de
冰似地: bīng shì de
卑俗地: bēi sú de
表示地: biǎo shì de
保守地: bǎo shǒu de
博识地: bó shí de
鄙俗地: bǐ sú de
鼻声地: bí shēng de
不停地: bù tíng de
变态地: biàn tài de
不同地: bù tóng de
悲痛地: bēi tòng de
不妥地: bù tuǒ de
不痛地: bù tòng de
本体地: běn tǐ de
病态地: bìng tài de
悲恸地: bēi tòng de
本文地: běn wén de
卑微地: bēi wēi de
不懈地: bù xiè de
不朽地: bù xiǔ de
不幸地: bù xìng de
必需地: bì xū de
表性地: biǎo xìng de
不逊地: bù xùn de
不祥地: bù xiáng de
必须地: bì xū de
背信地: bèi xìn de
博学地: bó xué de
跛行地: bǒ xíng de
必要地: bì yào de
抱怨地: bào yuàn de
边缘地: biān yuán de
比喻地: bǐ yù de
不怨地: bù yuàn de
不雅地: bù yǎ de
不疑地: bù yí de
不义地: bú yì de
不易地: bù yì de
不悦地: bú yuè de
变溢地: biàn yì de
鼻音地: bí yīn de
不住地: bú zhù de
笔直地: bǐ zhí de
笨拙地: bèn zhuō de
逼真地: bī zhēn de
暴躁地: bào zào de
不正地: bù zhèng de
不贞地: bù zhēn de
不足地: bù zú de
不忠地: bù zhōng de
不智地: bù zhì de
比照地: bǐ zhào de
半周地: bàn zhōu de
白昼地: bái zhòu de
别致地: bié zhì de
补助地: bǔ zhù de
保证地: bǎo zhèng de
变则地: biàn zé de
标准地: biāo zhǔn de
编造地: biān zào de
爆炸地: bào zhà de
笨重地: bèn zhòng de
草率地: cǎo shuài de
嘲弄地: cháo nòng de
粗略地: cū lüè de
从容地: cóng róng de
灿烂地: càn làn de
残忍地: cán rěn de
粗鲁地: cū lǔ de
吃力地: chī lì de
丑陋地: chǒu lòu de
丑恶地: chǒu è de
产粮地: chǎn liáng de
传染地: chuán rǎn de
成列地: chéng liè de
吵闹地: chǎo nào de
赤裸地: chì luǒ de
刺耳地: cì ěr de
炽燃地: chì rán de
耻辱地: chǐ rǔ de
脆弱地: cuì ruò de
逞能地: chěng néng de
粗劣地: cū liè de
粗卤地: cū lǔ de
粗陋地: cū lòu de
粗率地: cū lǜ de
策略地: cè lüè de
超人地: chāo rén de
磁力地: cí lì de
残暴地: cán bào de
粗暴地: cū bào de
崇拜地: chóng bài de
粗笨地: cū bèn de
粗鄙地: cū bǐ de
催逼地: cuī bī de
慈悲地: cí bēi de
沉重地: chén zhòng de
长长地: cháng cháng de
纯纯地: chún chún de
仓促地: cāng cù de
匆匆地: cōng cōng de
处长地: chù zhǎng de
纯粹地: chún cuì de
迟迟地: chí chí de
重重地: zhòng zhòng de
粗糙地: cū cāo de
痴痴地: chī chī de
吃吃地: chī chī de
处处地: chǔ chù de
常常地: cháng cháng de
粗粗地: cū cū de
踌躇地: chóu chú de
彻底地: chè dǐ de
颤抖地: chàn dǒu de
程度地: chéng dù de
迟钝地: chí dùn de
嚓地响: cā de xiǎng
长度地: cháng dù de
传道地: chuán dào de
冲动地: chōng dòng de
成对地: chéng duì de
迟到地: chí dào de
惨淡地: cǎn dàn de
痴呆地: chī dāi de
篡夺地: cuàn duó de
嘲讽地: cháo fěng de
充分地: chōng fèn de
重复地: chóng fù de
忏悔地: chàn huǐ de
迟缓地: chí huǎn de
陈腐地: chén fǔ de
粗厚地: cū hòu de
惩罚地: chéng fá de
朝后地: cháo hòu de
催化地: cuī huà de
成功地: chéng gōng de
丑怪地: chǒu guài de
刺骨地: cì gǔ de
残梗地: cán gěng de
触感地: chù gǎn de
冲积地: chōng jī de
吃惊地: chī jīng de
持久地: chí jiǔ de
出家地: chū jiā de
充军地: chōng jūn de
成角地: chéng jiǎo de
沉寂地: chén jì de
沉静地: chén jìng de
纯洁地: chún jié de
刺激地: cì jī de
采掘地: cǎi jué de
差劲地: chà jìn de
崇敬地: chóng jìng de
猜忌地: cāi jì de
插句地: chā jù de
错觉地: cuò jué de
出口地: chū kǒu de
诚恳地: chéng kěn de
残酷地: cán kù de
催眠地: cuī mián de
产米地: chǎn mǐ de
痴迷地: chī mí de
匆忙地: cōng máng de
沉默地: chén mò de
侧面地: cè miàn de
聪明地: cōng míng de
充满地: chōng mǎn de
沉闷地: chén mèn de
谄媚地: chǎn mèi de
愁闷地: chóu mèn de
稠密地: chóu mì de
嘲骂地: cháo mà de
聪敏地: cōng mǐn de
成批地: chéng pī de
草盘地: cǎo pán de
充沛地: chōng pèi de
淳朴地: chún pǔ de
出奇地: chū qí de
从前地: cóng qián de
长期地: cháng qī de
产气地: chǎn qì de
充气地: chōng qì de
初期地: chū qī de
凑巧地: còu qiǎo de
喘气地: chuǎn qì de
朝前地: cháo qián de
超群地: chāo qún de
出色地: chū sè de
出声地: chū shēng de
沉思地: chén sī de
粗俗地: cū sú de
出神地: chū shén de
传说地: chuán shuō de
成双地: chéng shuāng de
成束地: chéng shù de
成扇地: chéng shàn de
初始地: chū shǐ de
重述地: chóng shù de
重说地: zhòng shuō de
彩色地: cǎi sè de
粗声地: cū shēng de
朝上地: cháo shàng de
慈善地: cí shàn de
簇肆地: cù sì de
颤声地: chàn shēng de
惨痛地: cǎn tòng de
传统地: chuán tǒng de
刺透地: cì tòu de
刺痛地: cì tòng de
错误地: cuò wù de
嘲笑地: cháo xiào de
粗心地: cū xīn de
抽象地: chōu xiàng de
诚心地: chéng xīn de
持续地: chí xù de
存心地: cún xīn de
成线地: chéng xiàn de
吹嘘地: chuī xū de
侧向地: cè xiàng de
重新地: chóng xīn de
猜疑地: cāi yí de
粗野地: cū yě de
朝阳地: zhāo yáng de
充裕地: chōng yù de
成荫地: chéng yīn de
次月地: cì yuè de
迟延地: chí yán de
迟疑地: chí yí de
抽噎地: chōu yē de
差异地: chā yì de
颤音地: chàn yīn de
斥责地: chì zé de
垂直地: chuí zhí de
种子地: zhǒng zi de
纯种地: chún zhǒng de
充足地: chōng zú de
沉着地: chén zhuó de
诚挚地: chéng zhì de
叱责地: chì zé de
沉着地: chén zhuó de
纯正地: chún zhèng de
纯真地: chún zhēn de
称赞地: chēng zàn de
粗杂地: cū zá de
断然地: duàn rán de
代理地: dài lǐ de
大量地: dà liàng de
当然地: dāng rán de
独立地: dú lì de
髑髅地: dú lóu de
刁难地: diāo nàn de
大略地: dà lüè de
对偶地: duì ǒu de
电力地: diàn lì de
丢脸地: diū liǎn de
动人地: dòng rén de
多瘤地: duō liú de
低劣地: dī liè de
单人地: dān rén de
单耳地: dān ěr de
砀力地: dàng lì de
毒辣地: dú là de
淡然地: dàn rán de
大步地: dà bù de
多半地: duō bàn de
大半地: dà bàn de
大部地: dà bù de
代表地: dài biǎo de
对比地: duì bǐ de
多变地: duō biàn de
呆板地: dāi bǎn de
淡泊地: dàn bó de
淡薄地: dàn bó de
躲避地: duǒ bì de
颠簸地: diān bǒ de
单纯地: dān chún de
独创地: dú chuàng de
队沉地: duì chén de
代偿地: dài cháng de
对称地: duì chèn de
动词地: dòng cí de
多才地: duō cái de
低沉地: dī chén de
到处地: dào chù de
抵触地: dǐ chù de
独裁地: dú cái de
胆层地: dǎn céng de
大胆地: dà dǎn de
大大地: dà dà de
定定地: deng deng de
多多地: duō duō de
呆呆地: dāi dāi de
单调地: dān diào de
等地方: děng de fāng
敌对地: dí duì de
淡淡地: dàn dàn de
刀断地: dāo duàn de
对等地: duì děng de
呆钝地: dāi dùn de
单点地: dān diǎn de
怠惰地: dài duò de
独断地: dú duàn de
得当地: dé dàng de
掉队地: diào duì de
道德地: dào dé de
大方地: dà fāng de
捣鬼地: dǎo guǐ de
递归地: de guī de
蒂固地: de gù de
公认地: gōng rèn de
公然地: gōng rán de
甘乃地: gān nǎi de
光荣地: guāng róng de
挂念地: guà niàn de
鼓励地: gǔ lì de
个人地: gè rén de
干扰地: gān rǎo de
公理地: gōng lǐ de
归纳地: guī nà de
光亮地: guāng liàng de
过人地: guò rén de
过量地: guò liàng de
谷类地: gǔ lèi de
乖戾地: guāi lì de
国内地: guó nèi de
孤立地: gū lì de
官能地: guān néng de
官僚地: guān liáo de
惯例地: guàn lì de
感人地: gǎn rén de
概念地: gài niàn de
概略地: gài lüè de
严肃地: yán sù de
原始地: yuán shǐ de
一时地: yī shí de
友善地: yǒu shàn de
艺术地: yì shù de
仪式地: yí shì de
压缩地: yā suō de
有时地: yǒu shí de
阴森地: yīn sēn de
医术地: yī shù de
应时地: yìng shí de
应受地: yīng shòu de
忧伤地: yōu shāng de
远视地: yuǎn shì de
易逝地: yì shì de
易碎地: yì suì de
油似地: yóu shì de
音色地: yīn sè de
原速地: yuán sù de
庸俗地: yōng sú de
野兽地: yě shòu de
影射地: yǐng shè de
圆头地: yuán tóu de
圆通地: yuán tōng de
液体地: yè tǐ de
一味地: yī wèi de
一为地: yī wèi de
以往地: yǐ wǎng de
用完地: yòng wán de
仰卧地: yǎng wò de
有纹地: yǒu wén de
阳萎地: yáng wēi de
易忘地: yì wàng de
易弯地: yì wān de
勇武地: yǒng wǔ de
冤枉地: yuān wǎng de
原文地: yuán wén de
淫猥地: yín wěi de
遗忘地: yí wàng de
颖悟地: yǐng wù de
愿望地: yuàn wàng de
疑问地: yí wèn de
有效地: yǒu xiào de
油性地: yóu xìng de
悠闲地: yōu xián de
有形地: yǒu xíng de
一性地: yī xìng de
也许地: yě xǔ de
右旋地: yòu xuán de
优先地: yōu xiān de
优秀地: yōu xiù de
异相地: yì xiāng de
有性地: yǒu xìng de
阳性地: yáng xìng de
医学地: yī xué de
依序地: yī xù de
易行地: yì xíng de
英雄地: yīng xióng de
圆形地: yuán xíng de
谀逊地: yú xùn de
淫邪地: yín xié de
野性地: yě xìng de
隐形地: yǐn xíng de
游戏地: yóu xì de
越舷地: yuè xián de
影响地: yǐng xiǎng de
英勇地: yīng yǒng de
犹豫地: yóu yù de
幽幽地: yōu yōu de
遥遥地: yáo yáo de
隐隐地: yǐn yǐn de
有意地: yǒu yì de
一样地: yī yàng de
永远地: yǒng yuǎn de
永逸地: yǒng yì de
有余地: yǒu yú de
阴郁地: yīn yù de
硬硬地: yìng yìng de
遥远地: yáo yuǎn de
优越地: yōu yuè de
优雅地: yōu yǎ de
有氧地: yǒu yǎng de
有益地: yǒu yì de
阴影地: yīn yǐng de
妖艳地: yāo yàn de
应允地: yīng yǔn de
忧郁地: yōu yù de
抑压地: yì yā de
抑郁地: yì yù de
幽雅地: yōu yǎ de
盈溢地: yíng yì de
圆圆地: yuán yuán de
艳冶地: yàn yě de
揶揄地: yé yú de
隐喻地: yǐn yù de
寓言地: yù yán de
愉悦地: yú yuè de
摇曳地: yáo yè de
愿意地: yuàn yì de
演绎地: yǎn yì de
耀眼地: yào yǎn de
一致地: yí zhì de
幼稚地: yòu zhì de
有罪地: yǒu zuì de
一再地: yī zài de
一直地: yì zhí de
由衷地: yóu zhōng de
油榨地: yóu zhà de
雅致地: yǎ zhì de
一制地: yī zhì de
亚洲地: yà zhōu de
优致地: yōu zhì de
压制地: yā zhì de
宇宙地: yǔ zhòu de
有助地: yǒu zhù de
严正地: yán zhèng de
易知地: yì zhī de
盐渍地: yán zì de
预兆地: yù zhào de
意志地: yì zhì de
在内地: zài nèi de
罪恶地: zuì è de
自然地: zì rán de
执拗地: zhí niù de
杂乱地: zá luàn de
直率地: zhí shuài de
真龙地: zhēn lóng de
中立地: zhōng lì de
壮丽地: zhuàng lì de
执念地: zhí niàn de
自若地: zì ruò de
自律地: zì lǜ de
自傲地: zì ào de
灾难地: zāi nàn de
纵容地: zòng róng de
阻碍地: zǔ ài de
拙劣地: zhuō liè de
治疗地: zhì liáo de
终日地: zhōng rì de
责难地: zé nàn de
总论地: zǒng lùn de
钟爱地: zhōng ài de
挚爱地: zhì ài de
最乱地: zuì luàn de
照例地: zhào lì de
稚嫩地: zhì nèn de
憎恶地: zēng wù de
醉人地: zuì rén de
逐步地: zhú bù de
中板地: zhōng bǎn de
主笔地: zhǔ bǐ de
这边地: zhè biān de
责备地: zé bèi de
准备地: zhǔn bèi de
资本地: zī běn de
植被地: zhí bèi de
真诚地: zhēn chéng de
着重地: zhuó zhòng de
注册地: zhù cè de
正常地: zhèng cháng de
庄重地: zhuāng zhòng de
纵长地: zòng zhǎng de
忠诚地: zhōng chéng de
左侧地: zuǒ cè de
诈称地: zhà chēng de
展出地: zhǎn chū de
逐次地: zhú cì de
最初地: zuì chū de
遵从地: zūn cóng de
赞成地: zàn chéng de
主动地: zhǔ dòng de
得当地: dé dàng de
得胜地: dé shèng de
用心地: yòng xīn de
幼小地: yòu xiǎo de
黝暗地: yǒu àn de
幽暗地: yōu àn de
无故地: wú gù de
稳秘地: wěn mì de
微行地: wēi xíng de
无心地: wú xīn de
外源地: wài yuán de
望远地: wàng yuǎn de
甜美地: tián měi de
胎生地: tāi shēng de
透水地: tòu shuǐ de
唐突地: táng tū de
贴心地: tiē xīn de
剩下地: shèng xià de
盛大地: shèng dà de
攀针地: pān zhēn de
攀治地: pān zhì de
朴质地: pǔ zhì de
清白地: qīng bái de
清高地: qīng gāo de
齐平地: qí píng de
强求地: qiǎng qiú de
强取地: qiáng qǔ de
偏心地: piān xīn de
攀意地: pān yì de
攀育地: pān yù de
平易地: píng yì de
乖唳地: guāi lì de
欢娱地: huān yú de
对立地: duì lì de
充份地: chōng fèn de
常见地: cháng jiàn de
成就地: chéng jiù de
成熟地: chéng shú de
簇生地: cù shēng de
春天地: chūn tiān de
朝阳地: zhāo yáng de
残馀地: cán yú de
搀要地: chān yào de
词语地: cí yǔ de
诧异地: chà yì de
热液地: rè yè de
冗馀地: rǒng yú de
杠杠地: gàng gàng de
普遍地: pǔ biàn de
破旧地: pò jiù de
轻易地: qīng yì de
热心地: rè xīn de
忍从地: rěn cóng de
容易地: róng yì de
私下地: sī xià de
伤心地: shāng xīn de
实实地: shí shí de
倏地飞: shū de fēi
死死地: sǐ sǐ de
踏实地: tà shí de
坦白地: tǎn bái de
团团地: tuán tuán de
完美地: wán měi de
危险地: wēi xiǎn de
细心地: xì xīn de
向外地: xiàng wài de
向下地: xiàng xià de
消极地: xiāo jí de
小心地: xiǎo xīn de
幸福地: xìng fú de
意外地: yì wài de
远远地: yuǎn yuǎn de
真实地: zhēn shí de
忠实地: zhōng shí de
自立地: zì lì de
更远地: gèng yuǎn de
密封地: mì fēng de
陌生地: mò shēng de
频频地: pín pín de
黯然地: àn rán de
暗暗地: àn àn de
巴巴地: bā bā de
表现地: biǎo xiàn de
部份地: bù fèn de
惨白地: cǎn bái de
苍白地: cāng bái de
残余地: cán yú de
长久地: cháng jiǔ de
崇高地: chóng gāo de
打采地: dǎ cài de
等地租: děng de zū
堆笑地: duī xiào de
弱弱地: ruò ruò de
关切地: guān qiè de
封装地: fēng zhuāng de
轻声地: qīng shēng de
成倍地: chéng bèi de
成群地: chéng qún de
小小地: xiǎo xiǎo de
刷刷地: shuā shuā de
刻意地: kè yì de
气恼地: qì nǎo de
隐约地: yǐn yuē de
知趣地: zhī qù de
郑重地: zhèng zhòng de
她猛地: tā měng de
就把地: jiù bǎ de
轻柔地: qīng róu de
他猛地: tā měng de
很爽地: hěn shuǎng de
辩证地: biàn zhèng de
少少地: shǎo shǎo de
谈判地: tán pàn de
无端地: wú duān de
哧哧地: chī chī de
嘿嘿地: hēi hēi de
心疼地: xīn téng de
变相地: biàn xiàng de
快捷地: kuài jié de
委屈地: wěi qū de
担忧地: dān yōu de
低调地: dī diào de
腼腆地: miǎn tiǎn de
极力地: jí lì de
沉痛地: chén tòng de
技巧地: jì qiǎo de
调侃地: tiáo kǎn de
呐呐地: nà nà de
真正地: zhēn zhèng de
增长地: zēng zhǎng de
直直地: zhí zhí de
专注地: zhuān zhù de
正直地: zhèng zhí de
怔怔地: zhēng zhēng de
真挚地: zhēn zhì de
逐字地: zhú zì de
专制地: zhuān zhì de
之状地: zhī zhuàng de
正着地: zhèng zhe de
自主地: zì zhǔ de
住宅地: zhù zhái de
折衷地: shé zhōng de
诅咒地: zǔ zhòu de
阻止地: zǔ zhǐ de
忠贞地: zhōng zhēn de
肿胀地: zhǒng zhàng de
茁壮地: zhuó zhuàng de
指责地: zhǐ zé de
挣扎地: zhēng zhá de
政治地: zhèng zhì de
做作地: zuò zuò de
主要地: zhǔ yào de
正义地: zhèng yì de
注意地: zhù yì de
照样地: zhào yàng de
专业地: zhuān yè de
专有地: zhuān yǒu de
中庸地: zhōng yōng de
占有地: zhàn yǒu de
壮严地: zhuàng yán de
志愿地: zhì yuàn de
卓越地: zhuó yuè de
忠义地: zhōng yì de
直言地: zhí yán de
恣意地: zì yì de
缀翼地: zhuì yì de
职业地: zhí yè de
最优地: zuì yōu de
照耀地: zhào yào de
摘要地: zhāi yào de
镇压地: zhèn yā de
骤雨地: zhòu yǔ de
最终地: zuì zhōng de
足足地: zú zú de
谆谆地: zhūn zhūn de
自由地: zì yóu de
自苦地: zì kǔ de
展开地: zhǎn kāi de
最快地: zuì kuài de
专门地: zhuān mén de
正面地: zhèng miàn de
致命地: zhì mìng de
著名地: zhù míng de
字母地: zì mǔ de
字面地: zì miàn de
自明地: zì míng de
自满地: zì mǎn de
折磨地: zhé mó de
周密地: zhōu mì de
咒骂地: zhòu mà de
知名地: zhī míng de
着迷地: zháo mí de
最名地: zuì míng de
纵排地: zòng pái de
整批地: zhěng pī de
正派地: zhèng pài de
质朴地: zhì piáo de
正确地: zhèng què de
准确地: zhǔn què de
崭齐地: zhǎn qí de
整齐地: zhěng qí de
正切地: zhèng qiē de
在前地: zài qián de
早期地: zǎo qī de
周期地: zhōu qī de
珍奇地: zhēn qí de
钟情地: zhōng qíng de
最强地: zuì qiáng de
最趣地: zuì qù de
稚气地: zhì qì de
中省地: zhōng shěng de
扎实地: zhā shí de
正式地: zhèng shì de
再三地: zài sān de
准时地: zhǔn shí de
暂时地: zàn shí de
中伤地: zhòng shāng de
中速地: zhōng sù de
只是地: zhǐ shì de
再生地: zài shēng de
自私地: zì sī de
至上地: zhì shàng de
至死地: zhì sǐ de
贞淑地: zhēn shū de
注释地: zhù shì de
直爽地: zhí shuǎng de
终身地: zhōng shēn de
指数地: zhǐ shù de
轴上地: zhóu shàng de
追溯地: zhuī sù de
最上地: zuì shàng de
装饰地: zhuāng shì de
赞赏地: zàn shǎng de
逐条地: zhú tiáo de
糟透地: zāo tòu de
中凸地: zhōng tū de
暂停地: zàn tíng de
赞同地: zàn tóng de
糟蹋地: zāo tà de
支吾地: zhī wú de
周围地: zhōu wéi de
质问地: zhì wèn de
指望地: zhǐ wàng de
植物地: zhí wù de
谵妄地: zhān wàng de
仔细地: zǐ xì de
专心地: zhuān xīn de
中心地: zhōng xīn de
自信地: zì xìn de
置信地: zhì xìn de
赞许地: zàn xǔ de
正向地: zhèng xiàng de
在先地: zài xiān de
字形地: zì xíng de
早先地: zǎo xiān de
自形地: zì xíng de
纵向地: zòng xiàng de
直系地: zhí xì de
直线地: zhí xiàn de
指向地: zhǐ xiàng de
钻心地: zuān xīn de
最性地: zuì xìng de
最效地: zuì xiào de
最新地: zuì xīn de
整形地: zhěng xíng de
自愿地: zì yuàn de
庄严地: zhuāng yán de
怎样地: zěn yàng de
重要地: zhòng yào de
这样地: zhè yàng de
逐渐地: zhú jiàn de
最近地: zuì jìn de
中间地: zhōng jiān de
正交地: zhèng jiāo de
正经地: zhèng jīng de
在家地: zài jiā de
壮健地: zhuàng jiàn de
贞洁地: zhēn jié de
枝节地: zhī jié de
直角地: zhí jiǎo de
直进地: zhí jìn de
直觉地: zhí jué de
直截地: zhí jié de
知觉地: zhī jué de
最佳地: zuì jiā de
镇静地: zhèn jìng de
自夸地: zì kuā de
中肯地: zhōng kěn de
足够地: zú gòu de
逐个地: zhú gè de
整个地: zhěng gè de
糟糕地: zāo gāo de
主观地: zhǔ guān de
正规地: zhèng guī de
在贵地: zài guì de
壮观地: zhuàng guān de
至高地: zhì gāo de
直观地: zhí guān de
珍贵地: zhēn guì de
整洁地: zhěng jié de
着急地: zháo jí de
自觉地: zì jué de
尊敬地: zūn jìng de
自动地: zì dòng de
座地式: zuò de shì
最大地: zuì dà de
中断地: zhōng duàn de
中等地: zhōng děng de
自大地: zì dà de
作对地: zuò duì de
准点地: zhǔn diǎn de
振动地: zhèn dòng de
最度地: zuì dù de
镇定地: zhèn deng de
震动地: zhèn dòng de
最好地: zuì hǎo de
在后地: zài hòu de
自发地: zì fā de
自负地: zì fù de
自豪地: zì háo de
最后地: zuì hòu de
最坏地: zuì huài de
憎恨地: zēng hèn de
专横地: zhuān hèng de
之后地: zhī hòu de
支付地: zhī fù de
左方地: zuǒ fāng de
正好地: zhèng hǎo de
阵风地: zhèn fēng de
灾祸地: zāi huò de
忠厚地: zhōng hòu de
致害地: zhì hài de
造反地: zào fǎn de
着火地: zháo huǒ de
粘附地: zhān fù de
综合地: zōng hé de
最害地: zuì hài de
正当地: zhèng dāng de
重大地: zhòng dà de
一块地: yī kuài de
愉快地: yú kuài de
一刻地: yī kè de
用口地: yòng kǒu de
严酷地: yán kù de
严密地: yán mì de
园满地: yuán mǎn de
迎面地: yíng miàn de
油麻地: yóu má de
幽默地: yōu mò de
圆满地: yuán mǎn de
野蛮地: yě mán de
隐秘地: yǐn mì de
一忙地: yī máng de
有名地: yǒu míng de
郁闷地: yù mèn de
勇猛地: yǒng měng de
愚昧地: yú mèi de
耀目地: yào mù de
压迫地: yā pò de
有趣地: yǒu qù de
殷勤地: yīn qín de
一切地: yī qiè de
一气地: yī qì de
一齐地: yī qí de
尤其地: yóu qí de
以前地: yǐ qián de
仪器地: yí qì de
易曲地: yì qū de
勇气地: yǒng qì de
也似地: yě shì de
一觉地: yī jiào de
用尽地: yòng jǐn de
厌倦地: yàn juàn de
有局地: yǒu jú de
有角地: yǒu jiǎo de
有结地: yǒu jié de
英俊地: yīng jùn de
预见地: yù jiàn de
永久地: yǒng jiǔ de
有机地: yǒu jī de
严谨地: yán jǐn de
一定地: yí deng de
一胆地: yī dǎn de
异端地: yì duān de
有毒地: yǒu dú de
阴地厥: yīn de jué
应答地: yìng dá de
运动地: yùn dòng de
依地语: yī de yǔ
易读地: yì dú de
易懂地: yì dǒng de
诱导地: yòu dǎo de
音调地: yīn diào de
淫荡地: yín dàng de
隐遁地: yǐn dùn de
愚钝地: yú dùn de
摇动地: yáo dòng de
隐含地: yǐn hán de
遗憾地: yí hàn de
友好地: yǒu hǎo de
义愤地: yì fèn de
永恒地: yǒng héng de
优厚地: yōu hòu de
厌烦地: yàn fán de
迂回地: yū huí de
诱惑地: yòu huò de
已坏地: yǐ huài de
已废地: yǐ fèi de
以后地: yǐ hòu de
有害地: yǒu hài de
远房地: yuǎn fáng de
油滑地: yóu huá de
怨恨地: yuàn hèn de
圆滑地: yuán huá de
舀服地: yǎo fú de
淫秽地: yín huì de
眼花地: yǎn huā de
摇晃地: yáo huàng de
疑惑地: yí huò de
勇敢地: yǒng gǎn de
严格地: yán gé de
一贯地: yí guàn de
用功地: yòng gōng de
忧国地: yōu guó de
预感地: yù gǎn de
严峻地: yán jùn de
有力地: yǒu lì de
引力地: yǐn lì de
用力地: yòng lì de
有利地: yǒu lì de
有理地: yǒu lǐ de
严厉地: yán lì de
诱人地: yòu rén de
悦人地: yuè rén de
愠怒地: yùn nù de
一律地: yī lǜ de
一流地: yì liú de
厌恶地: yàn wù de
有礼地: yǒu lǐ de
医疗地: yī liáo de
忧虑地: yōu lǜ de
易怒地: yì nù de
油腻地: yóu nì de
沿岸地: yán àn de
哑然地: yǎ rán de
娱乐地: yú lè de
悦耳地: yuè ěr de
艳丽地: yàn lì de
隐匿地: yǐn nì de
游乐地: yóu lè de
遗漏地: yí lòu de
愚弄地: yú nòng de
韵律地: yùn lǜ de
毅然地: yì rán de
荫蔽地: yīn bì de
一般地: yì bān de
隐蔽地: yǐn bì de
一半地: yí bàn de
一板地: yī bǎn de
有病地: yǒu bìng de
易变地: yì biàn de
疫病地: yì bìng de
预备地: yù bèi de
愚笨地: yú bèn de
摇摆地: yáo bǎi de
严重地: yán zhòng de
愚蠢地: yú chǔn de
一次地: yī cì de
异常地: yì cháng de
匀称地: yún chèn de
依次地: yī cì de
永存地: yǒng cún de
延长地: yán cháng de
延迟地: yán chí de
阴沉地: yīn chén de
忧愁地: yōu chóu de
依从地: yī cóng de
辛苦地: xīn kǔ de
虚夸地: xū kuā de
迅猛地: xùn měng de
贤明地: xián míng de
凶猛地: xiōng měng de
鲜明地: xiān míng de
醒目地: xǐng mù de
细密地: xì mì de
显目地: xiǎn mù de
显明地: xiǎn míng de
羡慕地: xiàn mù de
向旁地: xiàng páng de
胁迫地: xié pò de
相配地: xiāng pèi de
新派地: xīn pài de
休憩地: xiū qì de
先前地: xiān qián de
向前地: xiàng qián de
羞怯地: xiū qiè de
小气地: xiǎo qì de
相齐地: xiāng qí de
香气地: xiāng qì de
消遣地: xiāo qiǎn de
喜气地: xǐ qì de
喜庆地: xǐ qìng de
新奇地: xīn qí de
迅速地: xùn sù de
稀疏地: xī shū de
闲散地: xián sǎn de
小声地: xiǎo shēng de
形式地: xíng shì de
辛酸地: xīn suān de
相似地: xiāng sì de
斜视地: xié shì de
小时地: xiǎo shí de
向上地: xiàng shàng de
向神地: xiàng shén de
驯顺地: xùn shùn de
孝顺地: xiào shùn de
学术地: xué shù de
现世地: xiàn shì de
细碎地: xì suì de
修饰地: xiū shì de
叙述地: xù shù de
牺牲地: xī shēng de
斜驶地: xié shǐ de
虚饰地: xū shì de
象上地: xiàng shàng de
稀少地: xī shǎo de
稀释地: xī shì de
锈蚀地: xiù shí de
想睡地: xiǎng shuì de
潇洒地: xiāo sǎ de
协调地: xié tiáo de
系统地: xì tǒng de
学堂地: xué táng de
相同地: xiāng tóng de
先天地: xiān tiān de
协同地: xié tóng de
萧条地: xiāo tiáo de
希望地: xī wàng de
些微地: xiē wēi de
泄物地: xiè wù de
细微地: xì wēi de
虚无地: xū wú de
虚伪地: xū wěi de
雄伟地: xióng wěi de
想望地: xiǎng wàng de
细细地: xì xì de
详细地: xiáng xì de
休息地: xiū xī de
形象地: xíng xiàng de
闲闲地: xián xián de
徐徐地: xú xú de
笑笑地: xiào xiào de
凶相地: xiōng xiàng de
戏谑地: xì xuè de
血腥地: xuè xīng de
欣喜地: xīn xǐ de
现行地: xiàn xíng de
相信地: xiāng xìn de
斜斜地: xié xié de
舷细地: xián xì de
谐谑地: xié xuè de
喧嚣地: xuān xiāo de
想象地: xiǎng xiàng de
嬉戏地: xī xì de
休闲地: xiū xián de
下野地: xià yě de
幸运地: xìng yùn de
相应地: xiāng yìng de
炫耀地: xuàn yào de
鲜艳地: xiān yàn de
乡音地: xiāng yīn de
休养地: xiū yǎng de
向右地: xiàng yòu de
驯养地: xùn yǎng de
性欲地: xìng yù de
信仰地: xìn yǎng de
响应地: xiǎng yìng de
显眼地: xiǎn yǎn de
相异地: xiāng yì de
相宜地: xiāng yí de
香郁地: xiāng yù de
喜悦地: xǐ yuè de
蓄意地: xù yì de
需要地: xū yào de
需氧地: xū yǎng de
显着地: xiǎn zhe de
旋转地: xuán zhuǎn de
闲置地: xián zhì de
限制地: xiàn zhì de
协作地: xié zuò de
狭窄地: xiá zhǎi de
斜着地: xié zhe de
象征地: xiàng zhēng de
原来地: yuán lái de
妖娆地: yāo ráo de
向后地: xiàng hòu de
信服地: xìn fú de
循环地: xún huán de
巡回地: xún huí de
西方地: xī fāng de
驯服地: xùn fú de
幸好地: xìng hǎo de
相互地: xiāng hù de
斜航地: xié háng de
虚幻地: xū huàn de
虚华地: xū huá de
喜欢地: xǐ huān de
喧哗地: xuān huá de
习惯地: xí guàn de
训诂地: xùn gǔ de
显贵地: xiǎn guì de
相关地: xiāng guān de
虚构地: xū gòu de
详尽地: xiáng jìn de
险峻地: xiǎn jùn de
下降地: xià jiàng de
下贱地: xià jiàn de
向家地: xiàng jiā de
戏剧地: xì jù de
学究地: xué jiū de
性急地: xìng jí de
相继地: xiāng jì de
选举地: xuǎn jǔ de
虚假地: xū jiǎ de
稀即地: xī jí de
新近地: xīn jìn de
羞愧地: xiū kuì de
相对地: xiāng duì de
相等地: xiāng děng de
新大地: xīn dà de
新地圩: xīn de wéi
下等地: xià děng de
心毒地: xīn dú de
向地地: xiàng de de
现代地: xiàn dài de
险陡地: xiǎn dǒu de
斜对地: xié duì de
斜地里: xié de lǐ
亵渎地: xiè dú de
销断地: xiāo duàn de
兴奋地: xīng fèn de
相反地: xiāng fǎn de
相当地: xiāng dāng de
喧闹地: xuān nào de
兴隆地: xīng lóng de
欣然地: xīn rán de
响亮地: xiǎng liàng de
显然地: xiǎn rán de
虚荣地: xū róng de
喜爱地: xǐ ài de
新粮地: xīn liáng de
下流地: xià liú de
凶恶地: xiōng è de
心理地: xīn lǐ de
协力地: xié lì de
向岸地: xiàng àn de
寻乐地: xún lè de
邪恶地: xié è de
驯良地: xùn liáng de
辛劳地: xīn láo de
辛辣地: xīn là de
性爱地: xìng ài de
信任地: xìn rèn de
信赖地: xìn lài de
洗礼地: xǐ lǐ de
炫丽地: xuàn lì de
狭隘地: xiá ài de
相连地: xiāng lián de
相容地: xiāng róng de
险恶地: xiǎn è de
消溶地: xiāo róng de
犀利地: xī lì de
像人地: xiàng rén de
嫌恶地: xián wù de
凶暴地: xiōng bào de
雄辩地: xióng biàn de
西部地: xī bù de
性别地: xìng bié de
修补地: xiū bǔ de
相比地: xiāng bǐ de
相并地: xiāng bìng de
想必地: xiǎng bì de
相称地: xiāng chèn de
习常地: xí cháng de
细长地: xì cháng de
相斥地: xiāng chì de
消沉地: xiāo chén de
无助地: wú zhù de
无知地: wú zhī de
无智地: wú zhì de
无罪地: wú zuì de
瓦渣地: wǎ zhā de
伪造地: wěi zào de
污浊地: wū zhuó de
婉转地: wǎn zhuǎn de
虚弱地: xū ruò de
嬉闹地: xī nào de
贤能地: xián néng de
戏弄地: xì nòng de
稳当地: wěn dāng de
无底地: wú dǐ de
无度地: wú dù de
无毒地: wú dú de
无敌地: wú dí de
外地地: wài de de
伟大地: wěi dà de
味淡地: wèi dàn de
武断地: wǔ duàn de
威风地: wēi fēng de
往复地: wǎng fù de
违法地: wéi fǎ de
无法地: wú fǎ de
温和地: wēn hé de
完好地: wán hǎo de
无害地: wú hài de
未婚地: wèi hūn de
污秽地: wū huì de
往后地: wǎng hòu de
顽固地: wán gù de
稳固地: wěn gù de
无关地: wú guān de
无感地: wú gǎn de
外国地: wài guó de
无尽地: wú jìn de
无稽地: wú jī de
外交地: wài jiāo de
外界地: wài jiè de
畏惧地: wèi jù de
误解地: wù jiě de
微急地: wēi jí de
稳健地: wěn jiàn de
挖苦地: wā kǔ de
微开地: wēi kāi de
无目地: wú mù de
微妙地: wēi miào de
无谋地: wú móu de
外面地: wài miàn de
诬蔑地: wū miè de
萎靡地: wěi mǐ de
顽皮地: wán pí de
无情地: wú qíng de
完全地: wán quán de
顽强地: wán qiáng de
无穷地: wú qióng de
婉曲地: wǎn qū de
无权地: wú quán de
无趣地: wú qù de
忘却地: wàng què de
弯曲地: wān qū de
卫生地: wèi shēng de
旺盛地: wàng shèng de
畏缩地: wèi suō de
温顺地: wēn shùn de
无上地: wú shàng de
无双地: wú shuāng de
无声地: wú shēng de
无私地: wú sī de
无数地: wú shù de
伪善地: wěi shàn de
无畏地: wú wèi de
哇哇地: wā wā de
歪歪地: wāi wāi de
嗡嗡地: wēng wēng de
魏瓦地: wèi wǎ de
稳稳地: wěn wěn de
无谓地: wú wèi de
微微地: wēi wēi de
委婉地: wěi wǎn de
忘我地: wàng wǒ de
无污地: wú wū de
无误地: wú wù de
无望地: wú wàng de
外围地: wài wéi de
翁翁地: wēng wēng de
温文地: wēn wén de
无效地: wú xiào de
无限地: wú xiàn de
歪斜地: wāi xié de
无血地: wú xuè de
无邪地: wú xié de
无性地: wú xìng de
外行地: wài háng de
外形地: wài xíng de
妄想地: wàng xiǎng de
违心地: wéi xīn de
往昔地: wǎng xī de
物学地: wù xué de
玩笑地: wán xiào de
猥亵地: wěi xiè de
微小地: wēi xiǎo de
微细地: wēi xì de
微笑地: wēi xiào de
威严地: wēi yán de
文雅地: wén yǎ de
无疑地: wú yí de
王有地: wáng yǒu de
无言地: wú yán de
无益地: wú yì de
无欲地: wú yù de
无意地: wú yì de
外因地: wài yīn de
天真地: tiān zhēn de
贴着地: tiē zhe de
条子地: tiáo zi de
挑战地: tiǎo zhàn de
退真地: tuì zhēn de
特征地: tè zhēng de
通则地: tōng zé de
停滞地: tíng zhì de
躺着地: tǎng zhe de
无礼地: wú lǐ de
无奈地: wú nài de
为难地: wéi nán de
无赖地: wú lài de
未来地: wèi lái de
围绕地: wéi rào de
温柔地: wēn róu de
微弱地: wēi ruò de
无力地: wú lì de
无能地: wú néng de
无虑地: wú lǜ de
无聊地: wú liáo de
无鞍地: wú ān de
外来地: wài lái de
污染地: wū rǎn de
枉然地: wǎng rán de
玩乐地: wán lè de
侮辱地: wǔ rǔ de
紊乱地: wěn luàn de
温暖地: wēn nuǎn de
微亮地: wēi liàng de
微量地: wēi liàng de
雾浓地: wù nóng de
无比地: wú bǐ de
无边地: wú biān de
外表地: wài biǎo de
稳步地: wěn bù de
五倍地: wǔ bèi de
务必地: wù bì de
外部地: wài bù de
温存地: wēn cún de
无耻地: wú chǐ de
无常地: wú cháng de
外侧地: wài cè de
完成地: wán chéng de
龌龊地: wò chuò de
稳定地: wěn deng de
特意地: tè yì de
凸圆地: tū yuán de
讨厌地: tǎo yàn de
同意地: tóng yì de
体育地: tǐ yù de
投影地: tóu yǐng de
拖延地: tuō yán de
同情地: tóng qíng de
提前地: tí qián de
痛切地: tòng qiè de
突起地: tū qǐ de
贴切地: tiē qiè de
淘气地: táo qì de
特殊地: tè shū de
天生地: tiān shēng de
同时地: tóng shí de
妥善地: tuǒ shàn de
通顺地: tōng shùn de
天上地: tiān shàng de
太甚地: tài shèn de
体视地: tǐ shì de
贪食地: tān shí de
特色地: tè sè de
通俗地: tōng sú de
探索地: tàn suǒ de
偷偷地: tōu tōu de
滔滔地: tāo tāo de
甜甜地: tián tián de
体贴地: tǐ tiē de
通透地: tōng tòu de
天体地: tiān tǐ de
吞吞地: tūn tūn de
挑剔地: tiāo tī de
统统地: tǒng tǒng de
疼痛地: téng tòng de
堂堂地: táng táng de
腾腾地: téng téng de
贪污地: tān wū de
体外地: tǐ wài de
推诿地: tuī wěi de
天性地: tiān xìng de
同形地: tóng xíng de
同相地: tóng xiāng de
图形地: tú xíng de
图型地: tú xíng de
贪心地: tān xīn de
退学地: tuì xué de
特性地: tè xìng de
通宵地: tōng xiāo de
通晓地: tōng xiǎo de
同样地: tóng yàng de
头晕地: tóu yūn de
同等地: tóng děng de
妥当地: tuǒ dàng de
退动地: tuì dòng de
特定地: tè deng de
调和地: tiáo hé de
天赋地: tiān fù de
讨好地: tǎo hǎo de
突发地: tū fā de
通红地: tòng hóng de
堂皇地: táng huáng de
颓废地: tuí fèi de
天盖地: tiān gài de
脱轨地: tuō guǐ de
托管地: tuō guǎn de
铜鼓地: tóng gǔ de
台阶地: tái jiē de
团结地: tuán jié de
体镜地: tǐ jìng de
统计地: tǒng jì de
脱节地: tuō jié de
痛苦地: tòng kǔ de
痛快地: tòng kuài de
透明地: tòu míng de
体面地: tǐ miàn de
甜蜜地: tián mì de
凸面地: tū miàn de
同盟地: tóng méng de
听从地: tīng cóng de
坦诚地: tǎn chéng de
贪财地: tān cái de
通畅地: tōng chàng de
通称地: tōng chēng de
跳动地: tiào dòng de
透彻地: tòu chè de
通常地: tōng cháng de
突出地: tū chū de
竖直地: shù zhí de
竖着地: shù zhe de
适中地: shì zhōng de
扇子地: shàn zi de
十足地: shí zú de
双折地: shuāng zhé de
氏族地: shì zú de
水准地: shuǐ zhǔn de
生殖地: shēng zhí de
似真地: shì zhēn de
爽直地: shuǎng zhí de
赎罪地: shú zuì de
数字地: shù zì de
坦率地: tǎn shuài de
突然地: tū rán de
徒劳地: tú láo de
天然地: tiān rán de
贪婪地: tān lán de
同量地: tóng liàng de
投入地: tóu rù de
退恶地: tuì è de
徒然地: tú rán de
泰然地: tài rán de
谈论地: tán lùn de
偷懒地: tōu lǎn de
推论地: tuī lùn de
推理地: tuī lǐ de
特别地: tè bié de
徒步地: tú bù de
同步地: tóng bù de
图表地: tú biǎo de
挑拨地: tiǎo bō de
逃避地: táo bì de
沙哑地: shā yǎ de
慎重地: shèn zhòng de
史学地: shǐ xué de
生息地: shēng xī de
设想地: shè xiǎng de
时新地: shí xīn de
神学地: shén xué de
首先地: shǒu xiān de
涉嫌地: shè xián de
兽性地: shòu xìng de
琐细地: suǒ xì de
属性地: shǔ xìng de
傻笑地: shǎ xiào de
私有地: sī yǒu de
随意地: suí yì de
首要地: shǒu yào de
善意地: shàn yì de
肆意地: sì yì de
嘶哑地: sī yǎ de
闪耀地: shǎn yào de
识趣地: shí qù de
生气地: shēng qì de
深切地: shēn qiè de
深情地: shēn qíng de
双亲地: shuāng qīn de
史前地: shǐ qián de
帅气地: shuài qì de
色情地: sè qíng de
似妻地: shì qī de
社区地: shè qū de
丧气地: sàng qì de
事前地: shì qián de
使气地: shǐ qì de
俗气地: sú qì de
神气地: shén qì de
神奇地: shén qí de
适切地: shì qiè de
擅权地: shàn quán de
深深地: shēn shēn de
松散地: sōng sǎn de
适时地: shì shí de
讪讪地: shàn shàn de
爽爽地: shuǎng shuǎng de
傻傻地: shǎ shǎ de
舒适地: shū shì de
闪烁地: shǎn shuò de
审慎地: shěn shèn de
松松地: sōng sōng de
深思地: shēn sī de
上诉地: shàng sù de
上述地: shàng shù de
少数地: shǎo shù de
世俗地: shì sú de
四散地: sì sàn de
生生地: shēng shēng de
生疏地: shēng shū de
守势地: shǒu shì de
伸缩地: shēn suō de
时式地: shí shì de
时时地: shí shí de
沙声地: shā shēng de
纱似地: shā shì de
事实地: shì shí de
受伤地: shòu shāng de
思索地: sī suǒ de
飒飒地: sà sà de
随手地: suí shǒu de
随时地: suí shí de
嗜杀地: shì shā de
瘦瘦地: shòu shòu de
算术地: suàn shù de
酸酸地: suān suān de
熟睡地: shú shuì de
失态地: shī tài de
生态地: shēng tài de
身体地: shēn tǐ de
渗透地: shèn tòu de
湿透地: shī tòu de
斯文地: sī wén de
失望地: shī wàng de
实习地: shí xí de
事先地: shì xiān de
顺序地: shùn xù de
熟悉地: shú xī de
松懈地: sōng xiè de
上下地: shàng xià de
随和地: suí hé de
十分地: shí fēn de
疏忽地: shū hū de
生辉地: shēng huī de
示范地: shì fàn de
伤害地: shāng hài de
守法地: shǒu fǎ de
神话地: shén huà de
适合地: shì hé de
适法地: shì fǎ de
顺风地: shùn fēng de
随后地: suí hòu de
稍缓地: shāo huǎn de
舒服地: shū fú de
闪光地: shǎn guāng de
三角地: sān jiǎo de
使劲地: shǐ jìn de
实际地: shí jì de
双节地: shuāng jié de
少见地: shǎo jiàn de
四角地: sì jiǎo de
时间地: shí jiān de
肃静地: sù jìng de
衰减地: shuāi jiǎn de
随机地: suí jī de
瞬间地: shùn jiān de
深刻地: shēn kè de
烧烤地: shāo kǎo de
爽快地: shuǎng kuài de
失控地: shī kòng de
诉苦地: sù kǔ de
实况地: shí kuàng de
尚可地: shàng kě de
爽口地: shuǎng kǒu de
散开地: sàn kāi de
稍快地: shāo kuài de
神秘地: shén mì de
时髦地: shí máo de
使命地: shǐ mìng de
审美地: shěn měi de
思慕地: sī mù de
说明地: shuō míng de
宿命地: sù mìng de
散漫地: sǎn màn de
三段地: sān duàn de
手动地: shǒu dòng de
生动地: shēng dòng de
上帝地: shàng de de
丝带地: sī dài de
扫荡地: sǎo dàng de
色调地: sè diào de
骚动地: sāo dòng de
适度地: shì dù de
顺利地: shùn lì de
私人地: sī rén de
饲料地: sì liào de
深入地: shēn rù de
深爱地: shēn ài de
少年地: shào nián de
生日地: shēng rì de
生来地: shēng lái de
生理地: shēng lǐ de
闪亮地: shǎn liàng de
杀人地: shā rén de
势利地: shì lì de
视力地: shì lì de
俗丽地: sú lì de
思虑地: sī lǜ de
省略地: shěng lüè de
神灵地: shén líng de
胜任地: shèng rèn de
顺流地: shùn liú de
兽类地: shòu lèi de
深虑地: shēn lǜ de
深奥地: shēn ào de
爽朗地: shuǎng lǎng de
盛怒地: shèng nù de
善良地: shàn liáng de
属类地: shǔ lèi de
散乱地: sǎn luàn de
湿冷地: shī lěng de
湿润地: shī rùn de
骚乱地: sāo luàn de
骚扰地: sāo rǎo de
僧侣地: sēng lǚ de
瘦弱地: shòu ruò de
熟虑地: shú lǜ de
随便地: suí biàn de
三倍地: sān bèi de
十倍地: shí bèi de
四倍地: sì bèi de
失败地: shī bài de
思辩地: sī biàn de
顺便地: shùn biàn de
善变地: shàn biàn de
善辩地: shàn biàn de
散布地: sàn bù de
双重地: shuāng chóng de
舒畅地: shū chàng de
三次地: sān cì de
三重地: sān chóng de
失常地: shī cháng de
失策地: shī cè de
时常地: shí cháng de
纱橱地: shā chú de
松弛地: sōng chí de
述词地: shù cí de
顺从地: shùn cóng de
顺畅地: shùn chàng de
奢侈地: shē chǐ de
渗出地: shèn chū de
稍迟地: shāo chí de
瘦长地: shòu cháng de
擅长地: shàn cháng de
适当地: shì dàng de
平淡地: píng dàn de
庞大地: páng dà de
品端地: pǐn duān de
砰地响: pēng de xiǎng
砰地撞: pēng de zhuàng
飘动地: piāo dòng de
频繁地: pín fán de
贫乏地: pín fá de
配合地: pèi hé de
平凡地: píng fán de
平和地: píng hé de
平放地: píng fàng de
平滑地: píng huá de
平衡地: píng héng de
匍匐地: pú fú de
破坏地: pò huài de
徘徊地: pái huái de
漂浮地: piāo fú de
癖好地: pǐ hào de
平静地: píng jìng de
平均地: píng jūn de
疲倦地: pí juàn de
普及地: pǔ jí de
片刻地: piàn kè de
贫困地: pín kùn de
拚命地: pàn mìng de
片面地: piàn miàn de
频密地: pín mì de
批判地: pī pàn de
偏僻地: piān pì de
贫穷地: pín qióng de
迫切地: pò qiè de
偏巧地: piān qiǎo de
脾气地: pí qì de
拍摄地: pāi shè de
朴素地: pǔ sù de
朴实地: pǔ shí de
评释地: píng shì de
蹒跚地: pán shān de
排他地: pái tā de
平坦地: píng tǎn de
偏袒地: piān tǎn de
普通地: pǔ tōng de
扑通地: pū tōng de
平稳地: píng wěn de
排外地: pái wài de
咆哮地: páo xiāo de
怕羞地: pà xiū de
屏息地: bǐng xī de
派系地: pài xì de
便宜地: pián yí de
飘扬地: piāo yáng de
譬喻地: pì yù de
铺张地: pū zhāng de
平直地: píng zhí de
棚状地: péng zhuàng de
赔罪地: péi zuì de
碰撞地: pèng zhuàng de
片子地: piān zi de
轻率地: qīng shuài de
丘陵地: qiū líng de
亲热地: qīn rè de
全力地: quán lì de
全然地: quán rán de
亲爱地: qīn ài de
强烈地: qiáng liè de
确然地: què rán de
悄然地: qiǎo rán de
气馁地: qì něi de
全能地: quán néng de
全裂地: quán liè de
怯弱地: qiè ruò de
怯懦地: qiè nuò de
亲昵地: qīn nì de
侵入地: qīn rù de
侵略地: qīn lüè de
前任地: qián rèn de
前额地: qián é de
凄凉地: qī liáng de
情柔地: qíng róu de
清朗地: qīng lǎng de
晴朗地: qíng lǎng de
谦让地: qiān ràng de
勤劳地: qín láo de
全部地: quán bù de
强暴地: qiáng bào de
谦卑地: qiān bēi de
七倍地: qī bèi de
千倍地: qiān bèi de
区别地: qū bié de
浅薄地: qiǎn bó de
亲笔地: qīn bǐ de
虔诚地: qián chéng de
清楚地: qīng chǔ de
憔悴地: qiáo cuì de
凄惨地: qī cǎn de
清澈地: qīng chè de
气喘地: qì chuǎn de
全长地: quán zhǎng de
求疵地: qiú cī de
其次地: qí cì de
屈从地: qū cóng de
青春地: qīng chūn de
青翠地: qīng cuì de
前侧地: qián cè de
起初地: qǐ chū de
清彻地: qīng chè de
清脆地: qīng cuì de
清澄地: qīng chéng de
恰当地: qià dàng de
屈地街: qū de jiē
强调地: qiáng diào de
气动地: qì dòng de
屈地性: qū de xìng
秋地站: qiū de zhàn
清淡地: qīng dàn de
强大地: qiáng dà de
强夺地: qiáng duó de
愀动地: qiǎo dòng de
期待地: qī dài de
确定地: què deng de
气愤地: qì fèn de
恰好地: qià hǎo de
勤奋地: qín fèn de
巧合地: qiǎo hé de
启发地: qǐ fā de
其后地: qí hòu de
屈服地: qū fú de
前方地: qián fāng de
轻浮地: qīng fú de
缺乏地: quē fá de
期货地: qī huò de
潜伏地: qián fú de
谦恭地: qiān gōng de
奇怪地: qí guài de
乞丐地: qǐ gài de
起劲地: qǐ jìn de
清洁地: qīng jié de
巧捷地: qiǎo jié de
曲解地: qū jiě de
奇迹地: qí jì de
亲近地: qīn jìn de
前进地: qián jìn de
倾角地: qīng jiǎo de
虔敬地: qián jìng de
强劲地: qiáng jìng de
强健地: qiáng jiàn de
群居地: qún jū de
轻快地: qīng kuài de
穷困地: qióng kùn de
勤快地: qín kuài de
轻狂地: qīng kuáng de
轻蔑地: qīng miè de
巧妙地: qiǎo miào de
全面地: quán miàn de
奇妙地: qí miào de
启蒙地: qǐ méng de
亲密地: qīn mì de
前面地: qián miàn de
绻毛地: quǎn máo de
欺瞒地: qī mán de
勤勉地: qín miǎn de
强迫地: qiǎng pò de
俏皮地: qiào pí de
轻飘地: qīng piāo de
钦佩地: qīn pèi de
起泡地: qǐ pào de
确切地: què qiè de
轻轻地: qīng qīng de
怯怯地: qiè qiè de
悄悄地: qiāo qiāo de
亲切地: qīn qiè de
乞求地: qǐ qiú de
祈求地: qí qiú de
切实地: qiè shí de
轻松地: qīng sōng de
齐声地: qí shēng de
全身地: quán shēn de
全速地: quán sù de
启示地: qǐ shì de
歧视地: qí shì de
侵蚀地: qīn shí de
前述地: qián shù de
轻视地: qīng shì de
清爽地: qīng shuǎng de
骑士地: qí shì de
轻佻地: qīng tiāo de
全体地: quán tǐ de
前台地: qián tái de
清透地: qīng tòu de
轻微地: qīng wēi de
权威地: quán wēi de
期望地: qī wàng de
倾斜地: qīng xié de
谦逊地: qiān xùn de
清晰地: qīng xī de
齐心地: qí xīn de
栖息地: qī xī de
清醒地: qīng xǐng de
强行地: qiáng xíng de
确信地: què xìn de
谦虚地: qiān xū de
取笑地: qǔ xiào de
奇性地: qí xìng de
轻信地: qīng xìn de
趋向地: qū xiàng de
奇异地: qí yì de
轻盈地: qīng yíng de
情愿地: qíng yuàn de
区域地: qū yù de
权宜地: quán yí de
惬意地: qiè yì de
强硬地: qiáng yìng de
亲自地: qīn zì de
强壮地: qiáng zhuàng de
曲折地: qū zhé de
穹状地: qióng zhuàng de
前兆地: qián zhào de
前者地: qián zhě de
轻装地: qīng zhuāng de
球状地: qiú zhuàng de
强制地: qiáng zhì de
愀知地: qiǎo zhī de
欺诈地: qī zhà de
敲诈地: qiāo zhà de
胜利地: shèng lì de
失礼地: shī lǐ de
熟练地: shú liàn de
平安地: píng ān de
漂亮地: piào liàng de
漂流地: piāo liú de
怕人地: pà rén de
贫弱地: pín ruò de
叛乱地: pàn luàn de
叛逆地: pàn nì de
砰然地: pēng rán de
破例地: pò lì de
破烂地: pò làn de
偏爱地: piān ài de
骗人地: piàn rén de
旁边地: páng biān de
漂泊地: piāo bó de
叵测地: pǒ cè de
平常地: píng cháng de
平等地: píng děng de
满意地: mǎn yì de
满溢地: mǎn yì de
蔓延地: màn yán de
明智地: míng zhì de
埋葬地: mái zàng de
莽撞地: mǎng zhuàng de
猛乍地: měng zhà de
木制地: mù zhì de
民主地: mín zhǔ de
民族地: mín zú de
满足地: mǎn zú de
矛盾地: máo dùn de
冒渎地: mào dú de
迷地装: mí de zhuāng
梅毒地: méi dú de
梦多地: mèng duō de
猛地关: měng de guān
摩登地: mó dēng de
模糊地: mó hú de
免费地: miǎn fèi de
美好地: měi hǎo de
马虎地: mǎ hǔ de
迷惑地: mí huò de
迷糊地: mí hū de
麻烦地: má fán de
蛮横地: mán hèng de
模仿地: mó fǎng de
牧歌地: mù gē de
敏感地: mǐn gǎn de
魔鬼地: mó guǐ de
敏捷地: mǐn jié de
密集地: mì jí de
每季地: měi jì de
猛进地: měng jìn de
明快地: míng kuài de
慢慢地: màn màn de
满满地: mǎn mǎn de
秘密地: mì mì de
绵绵地: mián mián de
盲目地: máng mù de
莫名地: mò míng de
美妙地: měi miào de
密密地: mì mì de
默默地: mò mò de
命名地: mìng míng de
明媚地: míng mèi de
冒昧地: mào mèi de
美满地: měi mǎn de
密码地: mì mǎ de
麻木地: má mù de
明确地: míng què de
密切地: mì qiè de
勉强地: miǎn qiǎng de
目前地: mù qián de
藐视地: miǎo shì de
蔑视地: miè shì de
么似地: me shì de
免税地: miǎn shuì de
茂盛地: mào shèng de
冒失地: mào shī de
美术地: měi shù de
梦似地: mèng shì de
蔓生地: màn shēng de
苗条地: miáo tiáo de
迷途地: mí tú de
美味地: měi wèi de
谬误地: miù wù de
明显地: míng xiǎn de
明晰地: míng xī de
母系地: mǔ xì de
盲信地: máng xìn de
冒险地: mào xiǎn de
迷信地: mí xìn de
冥想地: míng xiǎng de
梦想地: mèng xiǎng de
描写地: miáo xiě de
慢性地: màn xìng de
默想地: mò xiǎng de
毛糙地: máo cāo de
每次地: měi cì de
冒充地: mào chōng de
勉从地: miǎn cóng de
猛冲地: měng chōng de
空前地: kōng qián de
肯切地: kěn qiè de
客气地: kè qì de
口腔地: kǒu qiāng de
可亲地: kě qīn de
苛求地: kē qiú de
恳求地: kěn qiú de
渴求地: kě qiú de
快速地: kuài sù de
瞌睡地: kē shuì de
口述地: kǒu shù de
开速地: kāi sù de
空手地: kōng shǒu de
苦涩地: kǔ sè de
宽松地: kuān sōng de
宽恕地: kuān shù de
口头地: kǒu tóu de
开拓地: kāi tuò de
可叹地: kě tàn de
苦痛地: kǔ tòng de
渴望地: kě wàng de
开胃地: kāi wèi de
狂文地: kuáng wén de
狂妄地: kuáng wàng de
空想地: kōng xiǎng de
开心地: kāi xīn de
可笑地: kě xiào de
科学地: kē xué de
开性地: kāi xìng de
开细地: kāi xì de
可信地: kě xìn de
可选地: kě xuǎn de
可惜地: kě xī de
可喜地: kě xǐ de
狂喜地: kuáng xǐ de
空心地: kōng xīn de
空闲地: kòng xián de
空虚地: kōng xū de
空暇地: kòng xiá de
苦行地: kǔ xíng de
抗议地: kàng yì de
可疑地: kě yí de
控于地: kòng yú de
开已地: kāi yǐ de
开硬地: kāi yìng de
可厌地: kě yàn de
夸耀地: kuā yào de
克已地: kè yǐ de
宽裕地: kuān yù de
垦殖地: kěn zhí de
夸张地: kuā zhāng de
枯燥地: kū zào de
开制地: kāi zhì de
可憎地: kě zēng de
空载地: kōng zài de
靠着地: kào zhe de
猛烈地: měng liè de
敏锐地: mǐn ruì de
马拉地: mǎ lā de
茫然地: máng rán de
木然地: mù rán de
忙乱地: máng luàn de
忙碌地: máng lù de
每年地: měi nián de
明亮地: míng liàng de
美丽地: měi lì de
迷人地: mí rén de
名人地: míng rén de
每日地: měi rì de
闷热地: mēn rè de
卖力地: mài lì de
明了地: míng liǎo de
明朗地: míng lǎng de
贸然地: mào rán de
迷恋地: mí liàn de
骂人地: mà rén de
猛拉地: měng lā de
猛然地: měng rán de
模拟地: mó nǐ de
漫然地: màn rán de
魅力地: mèi lì de
默认地: mò rèn de
朦胧地: méng lóng de
明白地: míng bái de
木板地: mù bǎn de
目标地: mù biāo de
可恨地: kě hèn de
开风地: kāi fēng de
开发地: kāi fā de
开花地: kāi huā de
可贺地: kě hè de
困惑地: kùn huò de
狂风地: kuáng fēng de
狂欢地: kuáng huān de
宽宏地: kuān hóng de
宽厚地: kuān hòu de
可贵地: kě guì de
客观地: kè guān de
可观地: kě guān de
宽广地: kuān guǎng de
靠近地: kào jìn de
可见地: kě jiàn de
可惊地: kě jīng de
可教地: kě jiào de
可敬地: kě jìng de
可嘉地: kě jiā de
考究地: kǎo jiū de
困窘地: kùn jiǒng de
空间地: kōng jiān de
科技地: kē jì de
空旷地: kōng kuàng de
可靠地: kě kào de
开垦地: kāi kěn de
口渴地: kǒu kě de
苛刻地: kē kè de
苦苦地: kǔ kǔ de
慷慨地: kāng kǎi de
阔阔地: kuò kuò de
开快地: kāi kuài de
可口地: kě kǒu de
快快地: kuài kuài de
空空地: kōng kōng de
宽阔地: kuān kuò de
苦闷地: kǔ mèn de
可怕地: kě pà de
可佩地: kě pèi de
恳切地: kěn qiè de
夸大地: kuā dà de
快活地: kuài huó de
肯定地: kěn deng de
宽大地: kuān dà de
空洞地: kōng dòng de
狡黠地: jiǎo xiá de
尽兴地: jìn xìng de
即兴地: jí xìng de
极小地: jí xiǎo de
间歇地: jiàn xiē de
侥幸地: jiǎo xìng de
居先地: jū xiān de
艰辛地: jiān xīn de
急需地: jí xū de
家系地: jiā xì de
痉笑地: jìng xiào de
积习地: jī xí de
继续地: jì xù de
假笑地: jiǎ xiào de
教训地: jiào xùn de
畸型地: jī xíng de
解析地: jiě xī de
精选地: jīng xuǎn de
紧要地: jǐn yào de
简要地: jiǎn yào de
节约地: jié yuē de
均匀地: jūn yún de
坚硬地: jiān yìng de
惊讶地: jīng yà de
激越地: jī yuè de
久远地: jiǔ yuǎn de
坚毅地: jiān yì de
极愚地: jí yú de
教育地: jiào yù de
教养地: jiào yǎng de
禁欲地: jìn yù de
僭越地: jiàn yuè de
精液地: jīng yè de
静养地: jìng yǎng de
僵硬地: jiāng yìng de
胶粘地: jiāo zhān de
静止地: jìng zhǐ de
集中地: jí zhōng de
假装地: jiǎ zhuāng de
尽早地: jǐn zǎo de
及早地: jí zǎo de
机智地: jī zhì de
径直地: jìng zhí de
急躁地: jí zào de
健壮地: jiàn zhuàng de
紧张地: jǐn zhāng de
脚着地: jiǎo zhe de
较早地: jiào zǎo de
节制地: jié zhì de
吉兆地: jí zhào de
奸诈地: jiān zhà de
狡诈地: jiǎo zhà de
剧增地: jù zēng de
竞争地: jìng zhēng de
胶着地: jiāo zhe de
酒醉地: jiǔ zuì de
渐增地: jiàn zēng de
矫正地: jiǎo zhèng de
焦躁地: jiāo zào de
禁止地: jìn zhǐ de
精致地: jīng zhì de
快乐地: kuài lè de
可怜地: kě lián de
可能地: kě néng de
狂乱地: kuáng luàn de
狂怒地: kuáng nù de
可忍地: kě rěn de
可哀地: kě āi de
可恶地: kě wù de
可爱地: kě ài de
困恼地: kùn nǎo de
困难地: kùn nán de
狂闹地: kuáng nào de
狂烈地: kuáng liè de
苦恼地: kǔ nǎo de
酷烈地: kù liè de
狂暴地: kuáng bào de
可怖地: kě bù de
刻板地: kè bǎn de
恐怖地: kǒng bù de
口部地: kǒu bù de
可变地: kě biàn de
可鄙地: kě bǐ de
刻薄地: kè bó de
空白地: kòng bái de
口吃地: kǒu chī de
可耻地: kě chǐ de
宽敞地: kuān chǎng de
极妙地: jí miào de
急忙地: jí máng de
紧密地: jǐn mì de
精密地: jīng mì de
机敏地: jī mǐn de
佳妙地: jiā miào de
娇媚地: jiāo mèi de
绝妙地: jué miào de
骄慢地: jiāo màn de
寂寞地: jì mò de
渐慢地: jiàn màn de
敬慕地: jìng mù de
简明地: jiǎn míng de
精明地: jīng míng de
精辟地: jīng pì de
紧迫地: jǐn pò de
近旁地: jìn páng de
俭朴地: jiǎn pǔ de
急迫地: jí pò de
简朴地: jiǎn piáo de
精确地: jīng què de
倔强地: jué jiàng de
坚强地: jiān qiáng de
急切地: jí qiè de
惊奇地: jīng qí de
精巧地: jīng qiǎo de
加强地: jiā qiáng de
尽情地: jìn qíng de
机巧地: jī qiǎo de
极其地: jí qí de
进取地: jìn qǔ de
俊俏地: jùn qiào de
健全地: jiàn quán de
教区地: jiào qū de
渐强地: jiàn qiáng de
激情地: jī qíng de
及时地: jí shí de
尖声地: jiān shēng de
即时地: jí shí de
近似地: jìn sì de
急速地: jí sù de
减速地: jiǎn sù de
棘手地: jí shǒu de
谨慎地: jǐn shèn de
加速地: jiā sù de
旧式地: jiù shì de
节省地: jié shěng de
尖瘦地: jiān shòu de
尖酸地: jiān suān de
技术地: jì shù de
拒收地: jù shōu de
极少地: jí shǎo de
近射地: jìn shè de
沮丧地: jǔ sàng de
金色地: jīn sè de
俭省地: jiǎn shěng de
疾速地: jí sù de
竞赛地: jìng sài de
假设地: jiǎ shè de
减损地: jiǎn sǔn de
接受地: jiē shòu de
渐少地: jiàn shǎo de
渐速地: jiàn sù de
矫饰地: jiǎo shì de
精神地: jīng shén de
爵士地: jué shì de
奇数地: jī shù de
江水地: jiāng shuǐ de
惊天地: jīng tiān de
交替地: jiāo tì de
具体地: jù tǐ de
集体地: jí tǐ de
急跳地: jí tiào de
精通地: jīng tōng de
静态地: jìng tài de
警惕地: jǐng tì de
绝望地: jué wàng de
及物地: jí wù de
极微地: jí wēi de
健忘地: jiàn wàng de
紧握地: jǐn wò de
精细地: jīng xì de
机械地: jī xiè de
集训地: jí xùn de
渐减地: jiàn jiǎn de
简洁地: jiǎn jié de
竭尽地: jié jìn de
尽快地: jǐn kuài de
即刻地: jí kè de
艰苦地: jiān kǔ de
健康地: jiàn kāng de
加快地: jiā kuài de
尖刻地: jiān kè de
极快地: jí kuài de
紧靠地: jǐn kào de
惊恐地: jīng kǒng de
渐快地: jiàn kuài de
窘困地: jiǒng kùn de
急急地: jí jí de
急剧地: jí jù de
假假地: jiǎ jiǎ de
接近地: jiē jìn de
集结地: jí jié de
聚集地: jù jí de
纠结地: jiū jié de
节俭地: jié jiǎn de
尖叫地: jiān jiào de
讲究地: jiǎng jiū de
极佳地: jí jiā de
拘谨地: jū jǐn de
经久地: jīng jiǔ de
经济地: jīng jì de
将近地: jiāng jìn de
狡猾地: jiǎo huá de
极好地: jí hǎo de
交互地: jiāo hù de
极坏地: jí huài de
较好地: jiào hǎo de
几乎地: jī hū de
讥讽地: jī fěng de
加害地: jiā hài de
纠纷地: jiū fēn de
机会地: jī huì de
拒付地: jù fù de
间或地: jiàn huò de
结合地: jié hé de
惊骇地: jīng hài de
惊慌地: jīng huāng de
教会地: jiào huì de
精悍地: jīng hàn de
籍贯地: jí guàn de
坚固地: jiān gù de
坚果地: jiān guǒ de
间隔地: jiàn gé de
警告地: jǐng gào de
警觉地: jǐng jué de
紧急地: jǐn jí de
寂静地: jì jìng de
机警地: jī jǐng de
积极地: jī jí de
渐渐地: jiàn jiàn de
坚决地: jiān jué de
紧紧地: jǐn jǐn de
静静地: jìng jìng de
焦急地: jiāo jí de
甲地左: jiǎ de zuǒ
极端地: jí duān de
季度地: jì dù de
激动地: jī dòng de
加地夫: jiā de fū
节地率: jié de lǜ
决定地: jué deng de
均等地: jūn děng de
近代地: jìn dài de
近端地: jìn duān de
间断地: jiàn duàn de
急动地: jí dòng de
倦怠地: juàn dài de
剧毒地: jù dú de
假定地: jiǎ deng de
悸动地: jì dòng de
教导地: jiào dǎo de
焦点地: jiāo diǎn de
嫉妒地: jí dù de
简单地: jiǎn dān de
极大地: jí dà de
讥刺地: jī cì de
纠缠地: jiū chán de
坚持地: jiān chí de
娇宠地: jiāo chǒng de
疾驰地: jí chí de
基础地: jī chǔ de
接触地: jiē chù de
巨大地: jù dà de
坚定地: jiān deng de
极度地: jí dù de
简短地: jiǎn duǎn de
绝对地: jué duì de
加倍地: jiā bèi de
局部地: jú bù de
九倍地: jiǔ bèi de
加班地: jiā bān de
进步地: jìn bù de
举办地: jǔ bàn de
简便地: jiǎn biàn de
激辩地: jī biàn de
经常地: jīng cháng de
几次地: jǐ cì de
交叉地: jiāo chā de
局促地: jú cù de
杰出地: jié chū de
急促地: jí cù de
精彩地: jīng cǎi de
饥饿地: jī è de
吉利地: jí lì de
尖锐地: jiān ruì de
坚尼地: jiān ní de
坚韧地: jiān rèn de
娇嫩地: jiāo nèn de
简略地: jiǎn lüè de
激烈地: jī liè de
几里地: jǐ lǐ de
计量地: jì liàng de
讥剌地: jī lá de
叫嚷地: jiào rǎng de
节日地: jié rì de
决然地: jué rán de
尽力地: jìn lì de
机灵地: jī líng de
纪念地: jì niàn de
坚忍地: jiān rěn de
坚牢地: jiān láo de
极弱地: jí ruò de
极恶地: jí è de
极难地: jí nán de
近来地: jìn lái de
拘泥地: jū nì de
娇弱地: jiāo ruò de
将来地: jiāng lái de
急拉地: jí lā de
急流地: jí liú de
兼任地: jiān rèn de
兼容地: jiān róng de
紧邻地: jǐn lín de
接纳地: jiē nà de
接连地: jiē lián de
渐弱地: jiàn ruò de
焦虑地: jiāo lǜ de
禁猎地: jìn liè de
简练地: jiǎn liàn de
截然地: jié rán de
精练地: jīng liàn de
精炼地: jīng liàn de
激昂地: jī áng de
激怒地: jī nù de
几倍地: jǐ bèi de
干燥地: gān zào de
各自地: gè zì de
固执地: gù zhí de
贯注地: guàn zhù de
刚着地: gāng zhe de
归罪地: guī zuì de
甘蔗地: gān zhè de
光泽地: guāng zé de
乖张地: guāi zhāng de
规则地: guī zé de
诡诈地: guǐ zhà de
贵族地: guì zú de
隔周地: gé zhōu de
鼓躁地: gǔ zào de
艰难地: jiān nán de
骄傲地: jiāo ào de
剧烈地: jù liè de
尽量地: jǐn liàng de
惊人地: jīng rén de
勾引地: gōu yǐn de
古雅地: gǔ yǎ de
归因地: guī yīn de
共有地: gòng yǒu de
刚勇地: gāng yǒng de
固有地: gù yǒu de
高雅地: gāo yǎ de
概要地: gài yào de
寡言地: guǎ yán de
过早地: guò zǎo de
公正地: gōng zhèng de
工作地: gōng zuò de
贵重地: guì zhòng de
更少地: gèng shǎo de
恭顺地: gōng shùn de
高声地: gāo shēng de
高尚地: gāo shàng de
光身地: guāng shēn de
过时地: guò shí de
过剩地: guò shèng de
攻势地: gōng shì de
根深地: gēn shēn de
歌珊地: gē shān de
跟上地: gēn shàng de
嘎声地: gā shēng de
光头地: guāng tóu de
共同地: gòng tóng de
固体地: gù tǐ de
感叹地: gǎn tàn de
滚烫地: gǔn tàng de
寡头地: guǎ tóu de
鼓舞地: gǔ wǔ de
高兴地: gāo xìng de
搞笑地: gǎo xiào de
光学地: guāng xué de
关系地: guān xì de
过细地: guò xì de
高效地: gāo xiào de
感性地: gǎn xìng de
感谢地: gǎn xiè de
管辖地: guǎn xiá de
故意地: gù yì de
供应地: gōng yìng de
概括地: gài kuò de
更快地: gèng kuài de
广阔地: guǎng kuò de
公开地: gōng kāi de
诡秘地: guǐ mì de
光明地: guāng míng de
共鸣地: gòng míng de
过敏地: guò mǐn de
国民地: guó mín de
该骂地: gāi mà de
乖僻地: guāi pì de
公平地: gōng píng de
规劝地: guī quàn de
刚强地: gāng qiáng de
乖巧地: guāi qiǎo de
搁浅地: gē qiǎn de
感情地: gǎn qíng de
各市地: gè shì de
感伤地: gǎn shāng de
更深地: gēng shēn de
恭谨地: gōng jǐn de
赶紧地: gǎn jǐn de
感激地: gǎn jī de
归咎地: guī jiù de
过急地: guò jí de
过激地: guò jī de
告诫地: gào jiè de
更加地: gèng jiā de
过份地: guò fèn de
更坏地: gèng huài de
规范地: guī fàn de
该罚地: gāi fá de
隔阂地: gé hé de
古怪地: gǔ guài de
高高地: gāo gāo de
乖乖地: guāi guāi de
尴尬地: gān gà de
咕咕地: gū gū de
公共地: gōng gòng de
各个地: gè gè de
怪怪地: guài guài de
果敢地: guǒ gǎn de
恭敬地: gōng jìng de
广泛地: guǎng fàn de
更好地: gèng hǎo de
过分地: guò fèn de
孤单地: gū dān de
怪诞地: guài dàn de
规定地: guī deng de
高大地: gāo dà de
感动地: gǎn dòng de
滚动地: gǔn dòng de
过渡地: guò dù de
更多地: gèng duō de
过多地: guò duō de
过度地: guò dù de
孤独地: gū dú de
果断地: guǒ duàn de
干脆地: gān cuì de
乖乘地: guāi chéng de
光彩地: guāng cǎi de
过迟地: guò chí de
构词地: gòu cí de
惯常地: guàn cháng de
搞错地: gǎo cuò de
个别地: gè bié de
广博地: guǎng bó de
古板地: gǔ bǎn de
刚愎地: gāng bì de
各别地: gè bié de
合宜地: hé yí de
怀疑地: huái yí de
罕有地: hǎn yǒu de
活跃地: huó yuè de
敷衍地: fū yǎn de
幻影地: huàn yǐng de
合意地: hé yì de
回忆地: huí yì de
好意地: hǎo yì de
欢迎地: huān yíng de
欢跃地: huān yuè de
欢愉地: huān yú de
含有地: hán yǒu de
厚颜地: hòu yán de
荒淫地: huāng yín de
诲淫地: huì yín de
婚姻地: hūn yīn de
喉音地: hóu yīn de
合作地: hé zuò de
厚重地: hòu zhòng de
烦躁地: fán zào de
互助地: hù zhù de
好战地: hào zhàn de
放纵地: fàng zòng de
环状地: huán zhuàng de
复杂地: fù zá de
浑浊地: hún zhuó de
悔罪地: huǐ zuì de
浮躁地: fú zào de
获准地: huò zhǔn de
混杂地: hùn zá de
混浊地: hún zhuó de
慌张地: huāng zhāng de
糊状地: hú zhuàng de
干练地: gàn liàn de
高傲地: gāo ào de
飞速地: fēi sù de
化石地: huà shí de
合适地: hé shì de
好色地: hào sè de
防守地: fáng shǒu de
很少地: hěn shǎo de
反射地: fǎn shè de
发射地: fā shè de
好胜地: hào shèng de
和声地: hé shēng de
和善地: hé shàn de
放肆地: fàng sì de
胡说地: hú shuō de
晦涩地: huì sè de
寒酸地: hán suān de
滑顺地: huá shùn de
毁损地: huǐ sǔn de
豪爽地: háo shuǎng de
荒唐地: huāng táng de
好听地: hǎo tīng de
坏透地: huài tòu de
沸腾地: fèi téng de
黄铜地: huáng tóng de
糊涂地: hú tú de
会晤地: huì wù de
乏味地: fá wèi de
好问地: hǎo wèn de
好玩地: hǎo wán de
宏伟地: hóng wěi de
抚慰地: fǔ wèi de
很晚地: hěn wǎn de
悔悟地: huǐ wù de
反向地: fǎn xiàng de
含蓄地: hán xù de
幻想地: huàn xiǎng de
诙谐地: huī xié de
互相地: hù xiāng de
好心地: hǎo xīn de
虎形地: hǔ xíng de
很细地: hěn xì de
含笑地: hán xiào de
化学地: huà xué de
反相地: fǎn xiāng de
方形地: fāng xíng de
好学地: hào xué de
好笑地: hǎo xiào de
欢喜地: huān xǐ de
芳香地: fāng xiāng de
和谐地: hé xié de
环行地: huán xíng de
环形地: huán xíng de
很小地: hěn xiǎo de
害羞地: hài xiū de
滑行地: huá xíng de
横向地: héng xiàng de
横斜地: héng xié de
福兴地: fú xīng de
华美地: huá měi de
缓慢地: huǎn màn de
化名地: huà míng de
和睦地: hé mù de
很慢地: hěn màn de
烦闷地: fán mèn de
慌忙地: huāng máng de
毁灭地: huǐ miè de
活泼地: huó pō de
和平地: hé píng de
黄婆地: huáng pó de
分批地: fēn pī de
合拍地: hé pāi de
好评地: hǎo píng de
哄骗地: hǒng piàn de
好奇地: hào qí de
和气地: hé qì de
风趣地: fēng qù de
合群地: hé qún de
废弃地: fèi qì de
肤浅地: fū qiǎn de
唤起地: huàn qǐ de
分散地: fēn sǎn de
附带地: fù dài de
狠毒地: hěn dú de
荒诞地: huāng dàn de
反对地: fǎn duì de
反动地: fǎn dòng de
火地岛: huǒ de dǎo
发达地: fā dá de
发抖地: fā dǒu de
回动地: huí dòng de
负地性: fù de xìng
放荡地: fàng dàng de
轰动地: hōng dòng de
很多地: hěn duō de
活动地: huó dòng de
海底地: hǎi dǐ de
海盗地: hǎi dào de
混蛋地: hùn dàn de
恒地营: héng de yíng
非凡地: fēi fán de
和缓地: hé huǎn de
含糊地: hán hú de
坏坏地: huài huài de
很好地: hěn hǎo de
狠狠地: hěn hěn de
缓缓地: huǎn huǎn de
好好地: hǎo hǎo de
悔恨地: huǐ hèn de
丰富地: fēng fù de
忿忿地: fèn fèn de
反复地: fǎn fù de
合法地: hé fǎ de
恨恨地: hèn hèn de
奋发地: fèn fā de
非法地: fēi fǎ de
厚厚地: hòu hòu de
黄昏地: huáng hūn de
辉煌地: huī huáng de
会话地: huì huà de
后悔地: hòu huǐ de
灰灰地: huī huī de
灰黄地: huī huáng de
怀恨地: huái hèn de
呼唤地: hū huàn de
和好地: hé hǎo de
挥霍地: huī huò de
绘画地: huì huà de
浮华地: fú huá de
符合地: fú hé de
豪华地: háo huá de
华贵地: huá guì de
合格地: hé gé de
回顾地: huí gù de
悔改地: huǐ gǎi de
横过地: héng guò de
滑稽地: huá jī de
幻觉地: huàn jué de
火急地: huǒ jí de
好久地: hǎo jiǔ de
罕见地: hǎn jiàn de
恒久地: héng jiǔ de
费解地: fèi jiě de
耗尽地: hào jìn de
喊叫地: hǎn jiào de
喝酒地: hē jiǔ de
富集地: fù jí de
何家地: hé jiā de
发狂地: fā kuáng de
很快地: hěn kuài de
飞快地: fēi kuài de
疯狂地: fēng kuáng de
欢快地: huān kuài de
愤慨地: fèn kǎi de
反抗地: fǎn kàng de
付款地: fù kuǎn de
好看地: hǎo kàn de
浮夸地: fú kuā de
横宽地: héng kuān de
荒谬地: huāng miù de
否定地: fǒu deng de
反常地: fǎn cháng de
讽刺地: fěng cì de
非常地: fēi cháng de
酣畅地: hān chàng de
合成地: hé chéng de
合唱地: hé chàng de
奉承地: fèng chéng de
服从地: fú cóng de
复仇地: fù chóu de
胡吹地: hú chuī de
唤出地: huàn chū de
喝采地: hè cǎi de
喝彩地: hè cǎi de
多汁地: duō zhī de
呆滞地: dāi zhì de
杜撰地: dù zhuàn de
定罪地: deng zuì de
带状地: dài zhuàng de
倒转地: dào zhuǎn de
倒栽地: dào zāi de
倒置地: dào zhì de
断奏地: duàn zòu de
端正地: duān zhèng de
端庄地: duān zhuāng de
欢乐地: huān lè de
混乱地: hùn luàn de
合理地: hé lǐ de
忿怒地: fèn nù de
愤怒地: fèn nù de
分离地: fēn lí de
发怒地: fā nù de
纷乱地: fēn luàn de
费力地: fèi lì de
化脓地: huà nóng de
风流地: fēng liú de
发亮地: fā liàng de
发案地: fā àn de
华丽地: huá lì de
后来地: hòu lái de
好乱地: hǎo luàn de
欢闹地: huān nào de
欢然地: huān rán de
含泪地: hán lèi de
怀念地: huái niàn de
和蔼地: hé ǎi de
和霭地: hé ǎi de
放任地: fàng rèn de
非难地: fēi nàn de
活力地: huó lì de
胡乱地: hú luàn de
荒凉地: huāng liáng de
海岸地: hǎi àn de
烦乱地: fán luàn de
烦恼地: fán nǎo de
获利地: huò lì de
寒冷地: hán lěng de
愤然地: fèn rán de
慌乱地: huāng luàn de
方便地: fāng biàn de
大致地: dà zhì de
独占地: dú zhàn de
独自地: dú zì de
短暂地: duǎn zàn de
动摇地: dòng yáo de
多言地: duō yán de
多雨地: duō yǔ de
多鱼地: duō yú de
多烟地: duō yān de
多疑地: duō yí de
大约地: dà yuē de
典型地: diǎn xíng de
大兴地: dà xīng de
大象地: dà xiàng de
胆小地: dǎn xiǎo de
当下地: dāng xià de
定性地: deng xìng de
担心地: dān xīn de
毒学地: dú xué de
笃信地: dǔ xìn de
达头地: dá tóu de
动听地: dòng tīng de
多数地: duō shù de
单手地: dān shǒu de
单数地: dān shù de
定时地: deng shí de
顶帅地: dǐng shuài de
淡色地: dàn sè de
动态地: dòng tài de
大声地: dà shēng de
低声地: dī shēng de
多情地: duō qíng de
定期地: deng qī de
胆怯地: dǎn qiè de
陡峭地: dǒu qiào de
刀强地: dāo qiáng de
打趣地: dǎ qù de
动情地: dòng qíng de
当前地: dāng qián de
对口地: duì kǒu de
癫狂地: diān kuáng de
倒霉地: dǎo méi de
怠慢地: dài màn de
妒忌地: dù jì de
递减地: de jiǎn de
堆积地: duī jī de
大口地: dà kǒu de
东方地: dōng fāng de
对话地: duì huà de
带灰地: dài huī de
敌方地: dí fāng de
短发地: duǎn fā de
大概地: dà gài de
单独地: dān dú de
冷冷地说: lěng lěng de shuō
你乐意地: nǐ lè yì de
努力地做: nǔ lì de zuò
哀哀地叫: āi āi de jiào
热烈地吻: rè liè de wěn
喃喃地说: nán nán de shuō
女人似地: nǚ rén shì de
奴隶般地: nú lì bān de
如雷般地: rú léi bān de
按年代地: àn nián dài de
按类别地: àn lèi bié de
流利地讲: liú lì de jiǎng
能忍耐地: néng rěn nài de
能理解地: néng lǐ jiě de
脑力上地: nǎo lì shàng de
难忍受地: nán rěn shòu de
理论上地: lǐ lùn shàng de
隆隆地响: lóng lóng de xiǎng
按比例地: àn bǐ lì de
你不断地: nǐ bù duàn de
冷不丁地: lěng bù dīng de
冷冰冰地: lěng bīng bīng de
冷不防地: lěng bù fáng de
了不起地: liǎo bù qǐ de
奴婢似地: nú bì shì de
忍不住地: rěn bú zhù de
难保证地: nán bǎo zhèng de
难辨别地: nán biàn bié de
难避免地: nán bì miǎn de
流畅地说: liú chàng de shuō
仍痴痴地: réng chī chī de
而重复地: ér chóng fù de
临床上地: lín chuáng shàng de
按常规地: àn cháng guī de
爱扯谎地: ài chě huǎng de
难处理地: nán chǔ lǐ de
潦草地写: liáo cǎo de xiě
唠叨地讲: láo dāo de jiǎng
难对付地: nán duì fù de
恶狠狠地: è hěn hěn de
乐呵呵地: lè hē hē de
狼嚎般地: láng háo bān de
爱幻想地: ài huàn xiǎng de
难和解地: nán hé jiě de
暖烘烘地: nuǎn hōng hōng de
能更好地: néng gèng hǎo de
恶棍般地: è gùn bān de
能共处地: néng gòng chǔ de
冷静地说: lěng jìng de shuō
仍静静地: réng jìng jìng de
理解地笑: lǐ jiě de xiào
内聚性地: nèi jù xìng de
难觉察地: nán jué chá de
难接近地: nán jiē jìn de
难解说地: nán jiě shuō de
凝结性地: níng jié xìng de
凝聚性地: níng jù xìng de
爱空想地: ài kōng xiǎng de
难宽恕地: nán kuān shù de
难控制地: nán kòng zhì de
爱冒险地: ài mào xiǎn de
欧美化地: ōu měi huà de
恶魔似地: è mó shì de
恶魔般地: è mó bān de
爱梦想地: ài mèng xiǎng de
你奇怪地: nǐ qí guài de
踉跄地走: liàng qiàng de zǒu
灵巧地做: líng qiǎo de zuò
难取悦地: nán qǔ yuè de
吝啬地给: lìn sè de gěi
亮闪闪地: liàng shǎn shǎn de
能生动地: néng shēng dòng de
能胜任地: néng shèng rèn de
能熟练地: néng shú liàn de
零碎地花: líng suì de huā
懊丧地说: ào sàng de shuō
厉声地说: lì shēng de shuō
如扇形地: rú shàn xíng de
逆时针地: nì shí zhēn de
爱生气地: ài shēng qì de
爱说话地: ài shuō huà de
难识别地: nán shí bié de
燃烧般地: rán shāo bān de
笼统地说: lǒng tǒng de shuō
笼统地喊: lǒng tǒng de hǎn
立体声地: lì tǐ shēng de
如屠夫地: rú tú fū de
肉体上地: ròu tǐ shàng de
笼统地讲: lǒng tǒng de jiǎng
人为地将: rén wéi de jiāng
女王般地: nǚ wáng bān de
你无私地: nǐ wú sī de
难为情地: nán wéi qíng de
泪汪汪地: lèi wāng wāng de
而相应地: ér xiāng yìng de
能迅速地: néng xùn sù de
人性上地: rén xìng shàng de
冷笑式地: lěng xiào shì de
良心上地: liáng xīn shàng de
能旋转地: néng xuán zhuǎn de
理想上地: lǐ xiǎng shàng de
懒洋洋地: lǎn yáng yáng de
那样地说: nà yàng de shuō
扼要地说: è yào de shuō
能有效地: néng yǒu xiào de
奶油似地: nǎi yóu shì de
容易错地: róng yì cuò de
爱游玩地: ài yóu wán de
难允许地: nán yǔn xǔ de
认真地听: rèn zhēn de tīng
认真地看: rèn zhēn de kàn
认真地吃: rèn zhēn de chī
按种别地: àn zhǒng bié de
仍执着地: réng zhí zhuó de
认真地写: rèn zhēn de xiě
能自觉地: néng zì jué de
能准确地: néng zhǔn què de
理智地把: lǐ zhì de bǎ
乱糟糟地: luàn zāo zāo de
男子似地: nán zi shì de
闹着玩地: nào zhe wán de
浓粥状地: nóng zhōu zhuàng de
恶作剧地: è zuò jù de
难转向地: nán zhuǎn xiàng de
骡子似地: luó zi shì de
不碍事地: bù ài shì de
不安全地: bù ān quán de
不安定地: bù ān deng de
不论何地: bù lùn hé de
不耐烦地: bù nài fán de
悲哀地说: bēi āi de shuō
不认真地: bù rèn zhēn de
不礼貌地: bù lǐ mào de
不老练地: bù lǎo liàn de
不吝惜地: bù lìn xī de
不灵巧地: bù líng qiǎo de
不连贯地: bù lián guàn de
不连续地: bù lián xù de
不流行地: bù liú xíng de
不留神地: bù liú shén de
不理会地: bù lǐ huì de
不脸红地: bù liǎn hóng de
波浪般地: bō làng bān de
玻璃似地: bō lí shì de
婢奴似地: bì nú shì de
白白地死: bái bái de sǐ
并不断地: bìng bù duàn de
不保险地: bù bǎo xiǎn de
不变化地: bù biàn huà de
巴巴儿地: bā bā ér de
不充分地: bù chōng fèn de
不充足地: bù chōng zú de
不成形地: bù chéng xíng de
不迟疑地: bù chí yí de
不诚恳地: bù chéng kěn de
不持久地: bù chí jiǔ de
不常有地: bù cháng yǒu de
不慈悲地: bù cí bēi de
不触目地: bù chù mù de
不踌躇地: bù chóu chú de
不得已地: bù dé yǐ de
不定时地: bù deng shí de
不断地抄: bù duàn de chāo
不断地练: bù duàn de liàn
不断地笑: bù duàn de xiào
不断地做: bù duàn de zuò
不定期地: bù deng qī de
不凋萎地: bù diāo wēi de
不得当地: bù dé dāng de
不得体地: bù dé tǐ de
不断地谈: bù duàn de tán
不道德地: bù dào dé de
不戴帽地: bù dài mào de
冰冻般地: bīng dòng bān de
被打扰地: bèi dǎ rǎo de
报复性地: bào fù xìng de
不服气地: bù fú qì de
不费力地: bù fèi lì de
便飞快地: biàn fēi kuài de
不分开地: bù fēn kāi de
不方便地: bù fāng biàn de
不发声地: bù fā shēng de
不合宜地: bù hé yí de
不合适地: bù hé shì de
不合理地: bù hé lǐ de
不好看地: bù hǎo kàn de
不含糊地: bù hán hù de
不和悦地: bù hé yuè de
不和谐地: bù hé xié de
不和蔼地: bù hé ǎi de
不服从地: bù fú cóng de
不活动地: bù huó dòng de
不活泼地: bù huó pō de
不害臊地: bù hài sào de
不慌忙地: bù huāng máng de
不慌张地: bù huāng zhāng de
不滑稽地: bù huá jī de
边反卷地: biān fǎn juǎn de
部份性地: bù fèn xìng de
暴风雨地: bào fēng yǔ de
不高兴地: bù gāo xìng de
并更好地: bìng gèng hǎo de
不公正地: bù gōng zhèng de
便固执地: biàn gù zhí de
便果断地: biàn guǒ duàn de
不固定地: bù gù deng de
不规则地: bù guī zé de
不规律地: bù guī lǜ de
不够格地: bù gòu gé de
半官方地: bàn guān fāng de
不精确地: bù jīng què de
不吉利地: bù jí lì de
不经济地: bù jīng jì de
不节俭地: bù jié jiǎn de
比较坏地: bǐ jiào huài de
不均衡地: bù jūn héng de
比较好地: bǐ jiào hǎo de
不坚固地: bù jiān gù de
不解地问: bù jiě de wèn
不解地说: bù jiě de shuō
不间断地: bù jiàn duàn de
不吉祥地: bù jí xiáng de
不经常地: bù jīng cháng de
不经意地: bù jīng yì de
不觉察地: bù jué chá de
八角形地: bā jiǎo xíng de
不及物地: bù jí wù de
不机敏地: bù jī mǐn de
不具名地: bù jù míng de
不健全地: bù jiàn quán de
不健康地: bù jiàn kāng de
不减退地: bù jiǎn tuì de
不减弱地: bù jiǎn ruò de
不精密地: bù jīng mì de
悲剧性地: bēi jù xìng de
不可解地: bù kě jiě de
不客气地: bú kè qì de
背靠背地: bèi kào bèi de
不可分地: bù kě fēn de
不可信地: bù kě xìn de
不可觉地: bù kě jué de
不可闻地: bù kě wén de
不可能地: bù kě néng de
不可数地: bù kě shù de
不可靠地: bù kě kào de
不夸张地: bù kuā zhāng de
不肯定地: bù kěn deng de
不宽恕地: bù kuān shù de
表开心地: biǎo kāi xīn de
不明确地: bù míng què de
不满地说: bù mǎn de shuō
不满足地: bù mǎn zú de
表面上地: biǎo miàn shàng de
被明确地: bèi míng què de
不名誉地: bù míng yù de
不明了地: bù míng le de
不明显地: bù míng xiǎn de
不明智地: bù míng zhì de
不冒昧地: bù mào mèi de
被冒犯地: bèi mào fàn de
不平常地: bù píng cháng de
不平衡地: bù píng héng de
不平坦地: bù píng tǎn de
不平稳地: bù píng wěn de
不疲倦地: bù pí juàn de
不配合地: bù pèi hé de
不偏离地: bù piān lí de
不漂亮地: bù piào liàng de
不恰当地: bù qià dàng de
不情愿地: bù qíng yuàn de
不清楚地: bù qīng chǔ de
不期然地: bù qī rán de
并巧妙地: bìng qiǎo miào de
抱歉地说: bào qiàn de shuō
便悄悄地: biàn qiāo qiāo de
不切题地: bú qiè tí de
不区别地: bù qū bié de
不屈曲地: bù qū qū de
不屈服地: bù qū fú de
不亲切地: bù qīn qiè de
不轻信地: bù qīng xìn de
不虔诚地: bù qián chéng de
不清洁地: bù qīng jié de
不确定地: bù què deng de
悲伤地哭: bēi shāng de kū
不生育地: bù shēng yù de
不时髦地: bù shí máo de
不适合地: bú shì hé de
不适宜地: bù shì yí de
不顺从地: bù shùn cóng de
不衰弱地: bù shuāi ruò de
不舒服地: bù shū fú de
不舒适地: bù shū shì de
不熟练地: bù shú liàn de
不熟悉地: bù shú xī de
保守地说: bǎo shǒu de shuō
不体面地: bù tǐ miàn de
不停地走: bù tíng de zǒu
不停顿地: bù tíng dùn de
不停地叫: bù tíng de jiào
不停地吃: bù tíng de chī
不停地说: bù tíng de shuō
不停地骂: bù tíng de mà
不停地淌: bù tíng de tǎng
不停地喊: bù tíng de hǎn
不停地嚼: bù tíng de jué
不同类地: bù tóng lèi de
不同等地: bù tóng děng de
不体贴地: bù tǐ tiē de
不听话地: bù tīng huà de
不坦诚地: bù tǎn chéng de
不突出地: bù tū chū de
不透明地: bú tòu míng de
不褪色地: bù tuì shǎi de
半透明地: bàn tòu míng de
蹦跳地走: bèng tiào de zǒu
不调和地: bù tiáo hé de
不稳定地: bù wěn deng de
不完全地: bù wán quán de
不卫生地: bù wèi shēng de
不完备地: bù wán bèi de
不完善地: bù wán shàn de
不畏惧地: bù wèi jù de
不畏缩地: bù wèi suō de
百万倍地: bǎi wàn bèi de
被侮辱地: bèi wǔ rǔ de
被歪曲地: bèi wāi qū de
不相称地: bù xiāng chèn de
不相等地: bù xiāng děng de
不习惯地: bù xí guàn de
不屑地说: bù xiè de shuō
并相应地: bìng xiāng yìng de
不休息地: bù xiū xī de
不协调地: bù xié tiáo de
不寻常地: bù xún cháng de
不许可地: bù xǔ kě de
不信相地: bù xìn xiāng de
不信神地: bù xìn shén de
不显着地: bù xiǎn zhe de
不相同地: bù xiāng tóng de
不相信地: bù xiāng xìn de
不相容地: bù xiāng róng de
不虚伪地: bù xū wěi de
不鲜明地: bù xiān míng de
巴西等地: bā xī děng de
半小时地: bàn xiǎo shí de
保险箱地: bǎo xiǎn xiāng de
不犹疑地: bù yóu yí de
不易弯地: bù yì wān de
不一致地: bù yī zhì de
不允许地: bù yǔn xǔ de
不友好地: bù yǒu hǎo de
不友善地: bù yǒu shàn de
不厌倦地: bù yàn juàn de
不延迟地: bù yán chí de
不严格地: bù yán gé de
不严密地: bù yán mì de
不应当地: bù yīng dāng de
不应得地: bù yīng de de
不犹豫地: bù yóu yù de
不幽默地: bù yōu mò de
不要脸地: bú yào liǎn de
不殷勤地: bù yīn qín de
不隐瞒地: bù yǐn mán de
不愉快地: bù yú kuài de
不雅观地: bù yǎ guān de
不愿意地: bù yuàn yì de
半意识地: bàn yì shí de
抱怨地说: bào yuàn de shuō
被遗弃地: bèi yí qì de
不正当地: bù zhèng dāng de
不知情地: bù zhī qíng de
不重要地: bú zhòng yào de
不仔细地: bù zǐ xì de
不正确地: bù zhèng què de
不在乎地: bù zài hū de
不在意地: bù zài yì de
不自觉地: bù zì jué de
不自然地: bù zì rán de
不住地说: bú zhù de shuō
不住地淌: bú zhù de tǎng
不住地跳: bú zhù de tiào
不正直地: bù zhèng zhí de
不正常地: bú zhèng cháng de
不自私地: bù zì sī de
不足取地: bù zú qǔ de
不足道地: bù zú dào de
不注意地: bù zhù yì de
不知名地: bù zhī míng de
不知足地: bù zhī zú de
不知觉地: bù zhī jué de
不值得地: bù zhí dé de
不整齐地: bù zhěng qí de
不整洁地: bù zhěng jié de
不赞成地: bù zàn chéng de
半正式地: bàn zhèng shì de
半自觉地: bàn zì jué de
本质上地: běn zhì shàng de
被诅咒地: bèi zǔ zhòu de
笨拙地做: bèn zhuō de zuò
编制上地: biān zhì shàng de
辩证法地: biàn zhèng fǎ de
草率地做: cǎo shuài de zuò
吃力地将: chī lì de jiāng
赤裸裸地: chì luǒ luǒ de
粗率地作: cū lǜ de zuò
嘲弄地骂: cháo nòng de mà
从容地走: cóng róng de zǒu
产量多地: chǎn liàng duō de
传染性地: chuán rǎn xìng de
层离法地: céng lí fǎ de
纯理论地: chún lǐ lùn de
粗略地说: cū lüè de shuō
超肉体地: chāo ròu tǐ de
成比例地: chéng bǐ lì de
常不免地: cháng bù miǎn de
差不多地: chà bù duō de
除不尽地: chú bù jìn de
吃吃地笑: chī chī de xiào
匆匆地走: cōng cōng de zǒu
痴痴地想: chī chī de xiǎng
嗤嗤地笑: chī chī de xiào
触电似地: chù diàn shì de
沉甸甸地: chén diàn diàn de
颤抖地说: chàn dǒu de shuō
彻底地做: chè dǐ de zuò
才缓缓地: cái huǎn huǎn de
成方形地: chéng fāng xíng de
重复地说: chóng fù de shuō
曾辉煌地: céng huī huáng de
嘲讽地说: cháo fěng de shuō
呈红色地: chéng hóng sè de
测海学地: cè hǎi xué de
朝红色地: cháo hóng sè de
成功地做: chéng gōng de zuò
成弓形地: chéng gōng xíng de
传记体地: zhuàn jì tǐ de
诚恳地说: chéng kěn de shuō
曾恐惧地: céng kǒng jù de
从开始地: cóng kāi shǐ de
曾明确地: céng míng què de
匆忙地做: cōng máng de zuò
出奇地静: chū qí de jìng
常亲切地: cháng qīn qiè de
出奇地快: chū qí de kuài
传奇似地: chuán qí shì de
传奇性地: chuán qí xìng de
成切线地: chéng qiè xiàn de
成群地游: chéng qún de yóu
吹求疵地: chuī qiú cī de
持球触地: chí qiú chù de
出声地哭: chū shēng de kū
出神地看: chū shén de kàn
处身设地: chǔ shēn shè de
尝试性地: cháng shì xìng de
粗声地说: cū shēng de shuō
尘世间地: chén shì jiān de
传统上地: chuán tǒng shàng de
成梯形地: chéng tī xíng de
吹微风地: chuī wēi fēng de
成楔形地: chéng xiē xíng de
抽象性地: chōu xiàng xìng de
惨兮兮地: cǎn xī xī de
抽噎地哭: chōu yē de kū
从远处地: cóng yuǎn chù de
创造性地: chuàng zào xìng de
沉重地走: chén zhòng de zǒu
沉重地行: chén zhòng de xíng
才自嘲地: cái zì cháo de
沉着地说: chén zhuó de shuō
成直角地: chéng zhí jiǎo de
成指数地: chéng zhǐ shù de
财政上地: cái zhèng shàng de
朝着云地: cháo zhe yún de
超自然地: chāo zì rán de
滴溜溜地: dī liū liū de
大剌剌地: dà lá lá de
大略地看: dà lüè de kàn
都认真地: dōu rèn zhēn de
都任性地: dōu rèn xìng de
大人似地: dà rén shì de
大量地给: dà liàng de gěi
多人口地: duō rén kǒu de
带露水地: dài lù shuǐ de
大部分地: dà bù fèn de
大鼻子地: dà bí zi de
代表性地: dài biǎo xìng de
多变化地: duō biàn huà de
低沉地说: dī chén de shuō
淡淡地说: dàn dàn de shuō
大胆地说: dà dǎn de shuō
大度地说: dà dù de shuō
大胆地干: dà dǎn de gàn
大胆地讲: dà dǎn de jiǎng
大胆地闯: dà dǎn de chuǎng
呆呆地看: dāi dāi de kàn
陡地一惊: dǒu de yī jīng
呆呆地想: dāi dāi de xiǎng
冬冬地敲: dōng dōng de qiāo
多洞穴地: duō dòng xué de
单调地唱: dān diào de chàng
弹道学地: dàn dào xué de
得得地响: dé dé de xiǎng
嗒嗒地响: dā dā de xiǎng
嗒嗒地跑: dā dā de pǎo
嘟嘟地喝: dū dū de hē
滴答地响: dī dá de xiǎng
大方地讲: dà fāng de jiǎng
大幅度地: dà fú dù de
多方面地: duō fāng miàn de
都好好地: dōu hǎo hǎo de
都豪迈地: dōu háo mài de
打呵欠地: dǎ hē qiàn de
多风波地: duō fēng bō de
当呼格地: dāng hū gé de
单方面地: dān fāng miàn de
待发育地: dài fā yù de
淡红色地: dàn hóng sè de
淡褐色地: dàn hè sè de
大概地说: dà gài de shuō
对过细地: duì guò xì de
多顾虑地: duō gù lǜ de
都接连地: dōu jiē lián de
都简单地: dōu jiǎn dān de
对角线地: duì jiǎo xiàn de
砰地关上: pēng de guān shàng
砰地放下: pēng de fàng xià
砰地一下: pēng de yī xià
砰地落下: pēng de là xià
砰地摔下: pēng de shuāi xià
砰地撞到: pēng de zhuàng dào
啪地一声: pā de yī shēng
噗地一声: pū de yī shēng
噗地喷出: pū de pēn chū
平地一声: píng de yī shēng
平地起风: píng de qǐ fēng
硬生生地: yìng shēng shēng de
要适当地: yào shì dàng de
友善地问: yǒu shàn de wèn
严肃地说: yán sù de shuō
一熟悉地: yī shú xī de
仪式上地: yí shì shàng de
印刷上地: yìn shuā shàng de
有生气地: yǒu shēng qì de
有收入地: yǒu shōu rù de
有诗意地: yǒu shī yì de
有胜败地: yǒu shèng bài de
有湿气地: yǒu shī qì de
易生气地: yì shēng qì de
易受伤地: yì shòu shāng de
易受骗地: yì shòu piàn de
耶稣会地: yē sū huì de
有条件地: yǒu tiáo jiàn de
有弹性地: yǒu tán xìng de
有条纹地: yǒu tiáo wén de
有条理地: yǒu tiáo lǐ de
圆筒形地: yuán tǒng xíng de
一万次地: yī wàn cì de
一窝蜂地: yī wō fēng de
一稳定地: yī wěn deng de
有问题地: yǒu wèn tí de
易忘记地: yì wàng jì de
易弯曲地: yì wān qū de
有选择地: yǒu xuǎn zé de
有系统地: yǒu xì tǒng de
有信心地: yǒu xìn xīn de
有效果地: yǒu xiào guǒ de
有兴味地: yǒu xìng wèi de
有兴趣地: yǒu xìng qù de
有希望地: yǒu xī wàng de
有学问地: yǒu xué wèn de
有效率地: yǒu xiào lǜ de
有旋律地: yǒu xuán lǜ de
易兴奋地: yì xīng fèn de
幽幽地说: yōu yōu de shuō
音乐般地: yīn yuè bān de
因用剡地: yīn yòng shàn de
有预谋地: yǒu yù móu de
有意识地: yǒu yì shí de
有意图地: yǒu yì tú de
隐隐地疼: yǐn yǐn de téng
引诱人地: yǐn yòu rén de
用言辞地: yòng yán cí de
用眼睛地: yòng yǎn jīng de
由远处地: yóu yuǎn chù de
有艺术地: yǒu yì shù de
有因果地: yǒu yīn guǒ de
有远虑地: yǒu yuǎn lǜ de
有勇气地: yǒu yǒng qì de
有原因地: yǒu yuán yīn de
有预见地: yǒu yù jiàn de
有营养地: yǒu yíng yǎng de
有硬皮地: yǒu yìng pí de
有意义地: yǒu yì yì de
有意志地: yǒu yì zhì de
有意思地: yǒu yì sī de
有毅力地: yǒu yì lì de
语言上地: yǔ yán shàng de
预言性地: yù yán xìng de
银一般地: yín yì bān de
演绎式地: yǎn yì shì de
有秩序地: yǒu zhì xù de
有准备地: yǒu zhǔn bèi de
有重点地: yǒu zhòng diǎn de
一再地吼: yī zài de hǒu
由衷地说: yóu zhōng de shuō
依职权地: yī zhí quán de
一直线地: yì zhí xiàn de
引注目地: yǐn zhù mù de
有自信地: yǒu zì xìn de
有助益地: yǒu zhù yì de
有知识地: yǒu zhī shí de
有组织地: yǒu zǔ zhī de
有粘性地: yǒu zhān xìng de
有滋味地: yǒu zī wèi de
应指责地: yīng zhǐ zé de
谀中伤地: yú zhòng shāng de
意志力地: yì zhì lì de
装内行地: zhuāng nèi háng de
在热情地: zài rè qíng de
直愣愣地: zhí lèng lèng de
贼溜溜地: zéi liū liū de
子女似地: zǐ nǚ shì de
在内部地: zài nèi bù de
在岸上地: zài àn shàng de
在南方地: zài nán fāng de
执拗地讲: zhí niù de jiǎng
拙劣地做: zhuō liè de zuò
直率地说: zhí shuài de shuō
责难似地: zé nàn shì de
最能上地: zuì néng shàng de
最理想地: zuì lǐ xiǎng de
中南部地: zhōng nán bù de
正不断地: zhèng bù duàn de
在不停地: zài bù tíng de
在不断地: zài bù duàn de
在不懈地: zài bù xiè de
足不离地: zú bù lí de
在本国地: zài běn guó de
在边际地: zài biān jì de
治不好地: zhì bù hǎo de
责备似地: zé bèi shì de
粘冰冰地: zhān bīng bīng de
中北部地: zhōng běi bù de
正吃力地: zhèng chī lì de
正错误地: zhèng cuò wù de
庄重地说: zhuāng zhòng de shuō
郑重地说: zhèng zhòng de shuō
真诚地去: zhēn chéng de qù
真诚地说: zhēn chéng de shuō
再创地量: zài chuàng de liàng
在床上地: zài chuáng shàng de
在船尾地: zài chuán wěi de
最长期地: zuì cháng qī de
这大大地: zhè dà dà de
很得意地: hěn dé yì de
看得见地: kàn dé jiàn de
往国外地: wǎng guó wài de
轻快地动: qīng kuài de dòng
纯合子地: chún hé zǐ de
不适切地: bù shì qiè de
不坦白地: bù tǎn bái de
不小心地: bù xiǎo xīn de
不等边地: bù děng biān de
不动心地: bù dòng xīn de
边对边地: biān duì biān de
不留心地: bù liú xīn de
不热心地: bù rè xīn de
不老实地: bù lǎo shí de
女主角地: nǚ zhǔ jué de
难战胜地: nán zhàn shèng de
都悄悄地: dōu qiāo qiāo de
多多地看: duō duō de kàn
多多地吻: duō duō de wěn
很腼腆地: hěn miǎn tiǎn de
狠狠地追: hěn hěn de zhuī
急赶急地: jí gǎn jí de
老地方等: lǎo de fāng děng
悄悄地瞄: qiāo qiāo de miáo
去大胆地: qù dà dǎn de
是杠杠地: shì gàng gàng de
也悄悄地: yě qiāo qiāo de
异常地快: yì cháng de kuài
有丁点地: yǒu dīng diǎn de
又傻傻地: yòu shǎ shǎ de
仔细地想: zǐ xì de xiǎng
一股脑地: yī gǔ nǎo de
不断地来: bù duàn de lái
不断地能: bù duàn de néng
不断地去: bù duàn de qù
不停地讲: bù tíng de jiǎng
不停地跳: bù tíng de tiào
不停地想: bù tíng de xiǎng
不眨眼地: bù zhǎ yǎn de
大胆地去: dà dǎn de qù
大胆地吻: dà dǎn de wěn
全身心地: quán shēn xīn de
神经质地: shén jīng zhì de
倏地一下: shū de yī xià
危险地方: wēi xiǎn de fāng
我衷心地: wǒ zhōng xīn de
细心地听: xì xīn de tīng
相当大地: xiāng dāng dà de
要清醒地: yào qīng xǐng de
要坚决地: yào jiān jué de
以有效地: yǐ yǒu xiào de
呱呱地叫: gū gū de jiào
关心地问: guān xīn de wèn
很耐心地: hěn nài xīn de
尽情地玩: jìn qíng de wán
暗暗地想: àn àn de xiǎng
不完美地: bù wán měi de
不必要地: bù bì yào de
不公平地: bù gōng píng de
不关心地: bù guān xīn de
不适当地: bù shì dāng de
不优美地: bù yōu měi de
不忠实地: bù zhōng shí de
粗率地作: cū lǜ de zuò
德配天地: dé pèi tiān de
他激动地: tā jī dòng de
没动地方: méi dòng de fāng
猛地一看: měng de yī kàn
谦虚地说: qiān xū de shuō
潇洒地走: xiāo sǎ de zǒu
军政要地: jūn zhèng yào de
兴冲冲地: xīng chōng chōng de
祖国内地: zǔ guó nèi de
很痛快地: hěn tòng kuài de
相当地快: xiāng dāng de kuài
能顺利地: néng shùn lì de
更谨慎地: gèng jǐn shèn de
能清楚地: néng qīng chǔ de
却不幸地: què bù xìng de
特别地累: tè bié de lèi
却隐隐地: què yǐn yǐn de
通俗地说: tōng sú de shuō
特别地酷: tè bié de kù
很巧妙地: hěn qiǎo miào de
更加地爱: gèng jiā de ài
慢慢地说: màn màn de shuō
惭愧地说: cán kuì de shuō
要抢地盘: yào qiǎng de pán
绝对地高: jué duì de gāo
还紧紧地: hái jǐn jǐn de
很自觉地: hěn zì jué de
安静地听: ān jìng de tīng
很有效地: hěn yǒu xiào de
猛地一顿: měng de yī dùn
要及时地: yào jí shí de
砰地一声: pēng de yī shēng
违规批地: wéi guī pī de
能很好地: néng hěn hǎo de
静静地看: jìng jìng de kàn
猛地转身: měng de zhuǎn shēn
轻快地说: qīng kuài de shuō
中肯地说: zhōng kěn de shuō
很听话地: hěn tīng huà de
很好地画: hěn hǎo de huà
好好地用: hǎo hǎo de yòng
偷偷地笑: tōu tōu de xiào
随意地打: suí yì de dǎ
要轻轻地: yào qīng qīng de
自觉地用: zì jué de yòng
真正地去: zhēn zhèng de qù
正呆呆地: zhèng dāi dāi de
要大大地: yào dà dà de
很好地用: hěn hǎo de yòng
渐渐地被: jiàn jiàn de bèi
轻轻地打: qīng qīng de dǎ
会逐渐地: huì zhú jiàn de
猛地住口: měng de zhù kǒu
非常地好: fēi cháng de hǎo
正慢慢地: zhèng màn màn de
要好好地: yāo hǎo hǎo de
很仔细地: hěn zǐ xì de
很体贴地: hěn tǐ tiē de
能快速地: néng kuài sù de
才真正地: cái zhēn zhèng de
出奇地低: chū qí de dī
放心地用: fàng xīn de yòng
很爽快地: hěn shuǎng kuài de
就坚决地: jiù jiān jué de
很干脆地: hěn gān cuì de
勉强地去: miǎn qiǎng de qù
又详细地: yòu xiáng xì de
艰难地说: jiān nán de shuō
低声地说: dī shēng de shuō
很安静地: hěn ān jìng de
痴痴地等: chī chī de děng
反复地问: fǎn fù de wèn
好奇地问: hào qí de wèn
能幸运地: néng xìng yùn de
好好地唱: hǎo hǎo de chàng
惊人地高: jīng rén de gāo
猛地一变: měng de yī biàn
才慢慢地: cái màn màn de
相当地火: xiāng dāng de huǒ
用力地挖: yòng lì de wā
正冷冷地: zhèng lěng lěng de
最快捷地: zuì kuài jié de
正卖力地: zhèng mài lì de
认真地去: rèn zhēn de qù
更准确地: gèng zhǔn què de
更成功地: gèng chéng gōng de
渐渐离地: jiàn jiàn lí de
更广泛地: gèng guǎng fàn de
猛地一震: měng de yī zhèn
要很好地: yào hěn hǎo de
慢慢地聊: màn màn de liáo
慢慢地从: màn màn de cóng
猛地缩小: měng de suō xiǎo
轻轻地咬: qīng qīng de yǎo
偷偷地将: tōu tōu de jiāng
慢慢地玩: màn màn de wán
想更快地: xiǎng gèng kuài de
想更好地: xiǎng gèng hǎo de
想更多地: xiǎng gèng duō de
甜蜜地说: tián mì de shuō
用力地砸: yòng lì de zá
正静静地: zhèng jìng jìng de
很害羞地: hěn hài xiū de
笑吟吟地: xiào yín yín de
非常地快: fēi cháng de kuài
静静地说: jìng jìng de shuō
不停地哭: bù tíng de kū
大量地做: dà liàng de zuò
担心地说: dān xīn de shuō
非常地慢: fēi cháng de màn
他清楚地: tā qīng chǔ de
不停地做: bù tíng de zuò
多么地好: duō me de hǎo
更深刻地: gēng shēn kè de
谁更好地: shéi gèng hǎo de
等地相继: děng de xiāng jì
非常地重: fēi cháng de zhòng
会冒失地: huì mào shī de
会不时地: huì bù shí de
更多地用: gèng duō de yòng
即将着地: jí jiāng zhe de
我真诚地: wǒ zhēn chéng de
也特别地: yě tè bié de
热情地向: rè qíng de xiàng
自然地物: zì rán de wù
正紧张地: zhèng jǐn zhāng de
会大量地: huì dà liàng de
成功地为: chéng gōng de wèi
笑呵呵地: xiào hē hē de
正乖乖地: zhèng guāi guāi de
急切地说: jí qiè de shuō
紧紧地把: jǐn jǐn de bǎ
坚定地走: jiān deng de zǒu
可不时地: kě bù shí de
屁股着地: pì gǔ zhe de
无方向地: wú fāng xiàng de
很随便地: hěn suí biàn de
狠狠地罚: hěn hěn de fá
很兴奋地: hěn xīng fèn de
打趣地说: dǎ qù de shuō
动情地说: dòng qíng de shuō
怯生生地: qiè shēng shēng de
郁闷地说: yù mèn de shuō
轻松地说: qīng sōng de shuō
甜甜地问: tián tián de wèn
能方便地: néng fāng biàn de
很厉害地: hěn lì hài de
相当地高: xiāng dāng de gāo
也是该地: yě shì gāi de
也相应地: yě xiāng yìng de
被人猛地: bèi rén měng de
单纯地去: dān chún de qù
很明智地: hěn míng zhì de
会深深地: huì shēn shēn de
会慢慢地: huì màn màn de
会乖乖地: huì guāi guāi de
就慢慢地: jiù màn màn de
静静地等: jìng jìng de děng
猛地推开: měng de tuī kāi
悄悄地说: qiāo qiāo de shuō
我仔细地: wǒ zǐ xì de
种到地里: zhǒng dào de lǐ
更努力地: gèng nǔ lì de
就永远地: jiù yǒng yuǎn de
安静地走: ān jìng de zǒu
不断地将: bù duàn de jiāng
能正确地: néng zhèng què de
还偷偷地: hái tōu tōu de
很顺手地: hěn shùn shǒu de
猛地跳起: měng de tiào qǐ
才认真地: cái rèn zhēn de
都紧紧地: dōu jǐn jǐn de
很自由地: hěn zì yóu de
很高兴地: hěn gāo xìng de
很稳定地: hěn wěn deng de
能极大地: néng jí dà de
并不时地: bìng bù shí de
轻轻地来: qīng qīng de lái
你大大地: nǐ dà dà de
很肯定地: hěn kěn deng de
还适当地: hái shì dàng de
特别地冻: tè bié de dòng
很紧张地: hěn jǐn zhāng de
客观地讲: kè guān de jiǎng
特别地忙: tè bié de máng
很幸运地: hěn xìng yùn de
客观地说: kè guān de shuō
自豪地说: zì háo de shuō
很遗憾地: hěn yí hàn de
太多地用: tài duō de yòng
我简单地: wǒ jiǎn dān de
眼红红地: yǎn hóng hóng de
淡淡地问: dàn dàn de wèn
石头似地: shí tou shì de
坦率地讲: tǎn shuài de jiǎng
有限度地: yǒu xiàn dù de
眼睁睁地: yǎn zhēng zhēng de
还同情地: hái tóng qíng de
急匆匆地: jí cōng cōng de
很方便地: hěn fāng biàn de
更加地快: gèng jiā de kuài
更轻松地: gèng qīng sōng de
更好地去: gèng hǎo de qù
将紧密地: jiāng jǐn mì de
将成功地: jiāng chéng gōng de
更多地在: gèng duō de zài
猛地跪下: měng de guì xià
撒娇似地: sā jiāo shì de
缩地成寸: suō de chéng cùn
好端端地: hǎo duān duān de
不停地笑: bù tíng de xiào
大声地哭: dà shēng de kū
很积极地: hěn jī jí de
哇哇地叫: wā wā de jiào
无奈地说: wú nài de shuō
小声地说: xiǎo shēng de shuō
认真地说: rèn zhēn de shuō
又一次地: yòu yī cì de
负责任地: fù zé rèn de
骄傲地说: jiāo ào de shuō
轻飘飘地: qīng piāo piāo de
真正地做: zhēn zhèng de zuò
自责地想: zì zé de xiǎng
扎扎地踏: zhā zhā de tà
在中心地: zài zhōng xīn de
在中间地: zài zhōng jiān de
吱吱地叫: zhī zhī de jiào
咂咂地吃: zā zā de chī
组织上地: zǔ zhī shàng de
组织论地: zǔ zhī lùn de
政治上地: zhèng zhì shàng de
做作地说: zuò zuò de shuō
粘着性地: zhān zhe xìng de
喳喳叫地: zhā zhā jiào de
照字义地: zhào zì yì de
照字面地: zhào zì miàn de
照宗规地: zhào zōng guī de
占主导地: zhàn zhǔ dǎo de
猪一般地: zhū yì bān de
职业上地: zhí yè shàng de
职业化地: zhí yè huà de
职业性地: zhí yè xìng de
装样子地: zhuāng yàng zi de
正默默地: zhèng mò mò de
在默默地: zài mò mò de
专门性地: zhuān mén xìng de
姐妹般地: jiě mèi bān de
照拍子地: zhào pāi zi de
周期性地: zhōu qī xìng de
正奇怪地: zhèng qí guài de
正起劲地: zhèng qǐ jìn de
正确地看: zhèng què de kàn
准确地说: zhǔn què de shuō
纵情地唱: zòng qíng de chàng
在其它地: zài qí tā de
在前方地: zài qián fāng de
职权或地: zhí quán huò de
最缺点地: zuì quē diǎn de
则深刻地: zé shēn kè de
正手击地: zhèng shǒu jī de
在上面地: zài shàng miàn de
在上流地: zài shàng liú de
自杀性地: zì shā xìng de
折射性地: zhé shè xìng de
最适宜地: zuì shì yí de
在痛苦地: zài tòng kǔ de
总偷偷地: zǒng tōu tōu de
直挺挺地: zhí tǐng tǐng de
支吾地说: zhī wú de shuō
再往前地: zài wǎng qián de
植物学地: zhí wù xué de
仔细地看: zǐ xì de kàn
钻心地疼: zuān xīn de téng
最下位地: zuì xià wèi de
最下面地: zuì xià miàn de
最有效地: zuì yǒu xiào de
再一次地: zài yí cì de
再用力地: zài yòng lì de
注意地听: zhù yì de tīng
注意地看: zhù yì de kàn
占优势地: zhàn yōu shì de
在远方地: zài yuǎn fāng de
着急地说: zháo jí de shuō
正焦急地: zhèng jiāo jí de
在机械地: zài jī xiè de
在剧烈地: zài jù liè de
着急地问: zháo jí de wèn
啁啾地叫: zhōu jiū de jiào
最节制地: zuì jié zhì de
最决定地: zuì jué deng de
在愤怒地: zài fèn nù de
装憨地问: zhuāng hān de wèn
正方形地: zhèng fāng xíng de
在后台地: zài hòu tái de
在后地在: zài hòu de zài
在附近地: zài fù jìn de
在海上地: zài hǎi shàng de
阵发性地: zhèn fā xìng de
政府拨地: zhèng fǔ bō de
涨红脸地: zhàng hóng liǎn de
做法人地: zuò fǎ rén de
直勾勾地: zhí gōu gōu de
整个儿地: zhěng gè ér de
宗规上地: zōng guī shàng de
照惯例地: zhào guàn lì de
针对性地: zhēn duì xìng de
征地卖地: zhēng de mài de
直瞪瞪地: zhí dèng dèng de
置地筑屋: zhì de zhù wū
在第七地: zài de qī de
张大口地: zhāng dà kǒu de
制度上地: zhì dù shàng de
战斗中地: zhàn dòu zhōng de
一口气地: yì kǒu qì de
愉快地唱: yú kuài de chàng
也慢慢地: yě màn màn de
油麻地站: yóu má de zhàn
幽默地说: yōu mò de shuō
一幕幕地: yí mù mù de
一名誉地: yī míng yù de
一明了地: yī míng liǎo de
用魔法地: yòng mó fǎ de
有名誉地: yǒu míng yù de
有魅力地: yǒu mèi lì de
游牧民地: yóu mù mín de
燕麦地组: yān mài de zǔ
一片片地: yī piàn piàn de
一疲倦地: yī pí juàn de
一排排地: yī pái pái de
有魄力地: yǒu pò lì de
又清晰地: yòu qīng xī de
也清醒地: yě qīng xǐng de
已悄悄地: yǐ qiāo qiāo de
已清楚地: yǐ qīng chǔ de
运气好地: yùn qì hǎo de
要恰当地: yào qià dàng de
一屈服地: yī qū fú de
已起床地: yǐ qǐ chuáng de
与前同地: yǔ qián tóng de
有区别地: yǒu qū bié de
有气派地: yǒu qì pài de
有全权地: yǒu quán quán de
有权威地: yǒu quán wēi de
有缺点地: yǒu quē diǎn de
有缺陷地: yǒu quē xiàn de
有趣味地: yǒu qù wèi de
易曲折地: yì qū zhé de
有计划地: yǒu jì huà de
有节制地: yǒu jié zhì de
有节奏地: yǒu jié zòu de
要坚定地: yào jiān deng de
一节俭地: yī jié jiǎn de
一均衡地: yī jūn héng de
永久性地: yǒng jiǔ xìng de
用假名地: yòng jiǎ míng de
有几分地: yǒu jǐ fēn de
有见识地: yǒu jiàn shí de
有价值地: yǒu jià zhí de
有机性地: yǒu jī xìng de
有机智地: yǒu jī zhì de
有结果地: yǒu jié guǒ de
有剧毒地: yǒu jù dú de
有教养地: yǒu jiào yǎng de
有焦点地: yǒu jiāo diǎn de
有精神地: yǒu jīng shén de
有爵位地: yǒu jué wèi de
远距离地: yuǎn jù lí de
易驾驭地: yì jià yù de
易觉察地: yì jué chá de
隐居性地: yǐn jū xìng de
演讲似地: yǎn jiǎng shì de
又反感地: yòu fǎn gǎn de
要合理地: yào hé lǐ de
疑惑地想: yí huò de xiǎng
疑惑地问: yí huò de wèn
匀厚地涂: yún hòu de tú
以合唱地: yǐ hé chàng de
有活力地: yǒu huó lì de
易发生地: yì fā shēng de
诱惑人地: yòu huò rén de
诱惑性地: yòu huò xìng de
遗憾地说: yí hàn de shuō
有规律地: yǒu guī lǜ de
一个劲地: yí gè jìn de
一个个地: yí gè gè de
也乖乖地: yě guāi guāi de
有规则地: yǒu guī zé de
严格地讲: yán gé de jiǎng
严格地说: yán gé de shuō
勇敢地对: yǒng gǎn de duì
要乖乘地: yào guāi chéng de
有光泽地: yǒu guāng zé de
有关电地: yǒu guān diàn de
有关连地: yǒu guān lián de
有关联地: yǒu guān lián de
易感知地: yì gǎn zhī de
易管理地: yì guǎn lǐ de
勇敢地与: yǒng gǎn de yǔ
已大大地: yǐ dà dà de
以地换地: yǐ de huàn de
雨点般地: yǔ diǎn bān de
一定义地: yí deng yì de
一定期地: yí deng qī de
以电报地: yǐ diàn bào de
压倒性地: yā dǎo xìng de
有毒害地: yǒu dú hài de
有胆量地: yǒu dǎn liàng de
有敌意地: yǒu dí yì de
有道德地: yǒu dào dé de
运动会地: yùn dòng huì de
音调好地: yīn diào hǎo de
也动情地: yě dòng qíng de
一点点地: yì diǎn diǎn de
易了解地: yì liǎo jiě de
幽灵似地: yōu líng shì de
已牢牢地: yǐ láo láo de
用力猛地: yòng lì měng de
有礼貌地: yǒu lǐ mào de
幽灵般地: yōu líng bān de
要认真地: yào rèn zhēn de
又讷讷地: yòu nè nè de
用力地打: yòng lì de dǎ
有力地说: yǒu lì de shuō
有耐性地: yǒu nài xìng de
有弱点地: yǒu ruò diǎn de
有恶臭地: yǒu è chòu de
易流泪地: yì liú lèi de
易理解地: yì lǐ jiě de
油腻腻地: yóu nì nì de
鱼类学地: yú lèi xué de
一般地说: yì bān de shuō
一步步地: yí bù bù de
一般地讲: yì bān de jiǎng
一般地指: yì bān de zhǐ
有步骤地: yǒu bù zhòu de
要不停地: yào bù tíng de
要不断地: yào bù duàn de
眼巴巴地: yǎn bā bā de
一不安地: yī bù ān de
一般性地: yì bān xìng de
一部分地: yī bù fèn de
用鼻拱地: yòng bí gǒng de
有把握地: yǒu bǎ wò de
有保留地: yǒu bǎo liú de
有帮助地: yǒu bāng zhù de
易变动地: yì biàn dòng de
易被瞒地: yì bèi mán de
一次次地: yī cì cì de
一次性地: yí cì xìng de
有成绩地: yǒu chéng jì de
有差别地: yǒu chā bié de
一成形地: yì chéng xíng de
用催眠地: yòng cuī mián de
有才能地: yǒu cái néng de
有成果地: yǒu chéng guǒ de
有差错地: yǒu chā cuò de
有臭味地: yǒu chòu wèi de
有常识地: yǒu cháng shí de
易处理地: yì chǔ lǐ de
遗传上地: yí chuán shàng de
笑眯眯地: xiào mī mī de
向旁边地: xiàng páng biān de
心歉歉地: xīn qiàn qiàn de
小气地给: xiǎo qì de gěi
兴趣浓地: xìng qù nóng de
像骑士地: xiàng qí shì de
像蔷薇地: xiàng qiáng wēi de
小说般地: xiǎo shuō bān de
向水性地: xiàng shuǐ xìng de
向湿性地: xiàng shī xìng de
吸湿性地: xī shī xìng de
形式上地: xíng shì shàng de
学术上地: xué shù shàng de
羞涩地看: xiū sè de kàn
象声词地: xiàng shēng cí de
潇洒地穿: xiāo sǎ de chuān
心痛地说: xīn tòng de shuō
乡土气地: xiāng tǔ qì de
向天空地: xiàng tiān kōng de
向头部地: xiàng tóu bù de
欣慰地笑: xīn wèi de xiào
学问上地: xué wèn shàng de
旋涡似地: xuán wō shì de
心虚地说: xīn xū de shuō
形象地将: xíng xiàng de jiāng
形象地说: xíng xiàng de shuō
形象地称: xíng xiàng de chēng
细细地读: xì xì de dú
详细地问: xiáng xì de wèn
笑嘻嘻地: xiào xī xī de
嘻笑地说: xī xiào de shuō
欣喜地说: xīn xǐ de shuō
乡下味地: xiāng xià wèi de
向心里地: xiàng xīn lǐ de
向西方地: xiàng xī fāng de
向西部地: xiàng xī bù de
性行为地: xìng xíng wèi de
现象上地: xiàn xiàng shàng de
细细地流: xì xì de liú
详细地说: xiáng xì de shuō
徐徐地吹: xú xú de chuī
想象上地: xiǎng xiàng shàng de
想象中地: xiǎng xiàng zhōng de
想像上地: xiǎng xiàng shàng de
嘘嘘地响: xū xū de xiǎng
狭义地说: xiá yì de shuō
先约略地: xiān yuē lüè de
狭义地讲: xiá yì de jiǎng
眩晕仆地: xuàn yūn pū de
下意识地: xià yì shí de
向右转地: xiàng yòu zhuǎn de
向药性地: xiàng yào xìng de
向原野地: xiàng yuán yě de
西洋化地: xī yáng huà de
吸引人地: xī yǐn rén de
想要似地: xiǎng yào shì de
献殷勤地: xiàn yīn qín de
象征性地: xiàng zhēng xìng de
选择性地: xuǎn zé xìng de
限制性地: xiàn zhì xìng de
有利益地: yǒu lì yì de
像幻影地: xiàng huàn yǐng de
习惯性地: xí guàn xìng de
小规模地: xiǎo guī mó de
雪糕新地: xuě gāo xīn de
小鬼似地: xiǎo guǐ shì de
雄赳赳地: xióng jiū jiū de
学究气地: xué jiū qì de
戏剧性地: xì jù xìng de
戏剧般地: xì jù bān de
性急地在: xìng jí de zài
迅捷地落: xùn jié de luò
戏剧化地: xì jù huà de
戏剧似地: xì jù shì de
斜靠式地: xié kào shì de
辛苦地干: xīn kǔ de gàn
辛苦地做: xīn kǔ de zuò
兴奋地说: xīng fèn de shuō
想好好地: xiǎng hǎo hǎo de
想狠狠地: xiǎng hěn hěn de
兴奋地喊: xīng fèn de hǎn
习很深地: xí hěn shēn de
向后转地: xiàng hòu zhuǎn de
向后面地: xiàng hòu miàn de
徐缓地吹: xú huǎn de chuī
相当地棒: xiāng dāng de bàng
相当地好: xiāng dāng de hǎo
想当然地: xiǎng dāng rán de
相对地说: xiāng duì de shuō
相当快地: xiāng dāng kuài de
笑到碌地: xiào dào lù de
兄弟似地: xiōng de shì de
兄弟般地: xiōng de bān de
向东方地: xiàng dōng fāng de
向地球地: xiàng de qiú de
许多倍地: xǔ duō bèi de
现代式地: xiàn dài shì de
修道士地: xiū dào shì de
修道院地: xiū dào yuàn de
咻地发声: xiū de fā shēng
相当多地: xiāng dāng duō de
斜地横过: xié de héng guò
像帝王地: xiàng de wáng de
向内部地: xiàng nèi bù de
心里陡地: xīn lǐ dǒu de
稀零零地: xī líng líng de
心理上地: xīn lǐ shàng de
心理学地: xīn lǐ xué de
形容词地: xíng róng cí de
像软木地: xiàng ruǎn mù de
像软片地: xiàng ruǎn piàn de
向北方地: xiàng běi fāng de
向边缘地: xiàng biān yuán de
想不到地: xiǎng bú dào de
小丑般地: xiǎo chǒu bān de
向侧面地: xiàng cè miàn de
向船尾地: xiàng chuán wěi de
相冲突地: xiāng chōng tū de
相称性地: xiāng chèn xìng de
喜吵架地: xǐ chǎo jià de
稀成性地: xī chéng xìng de
无法律地: wú fǎ lǜ de
无风浪地: wú fēng làng de
无分别地: wú fēn bié de
文化上地: wén huà shàng de
文法上地: wén fǎ shàng de
无活力地: wú huó lì de
无悔意地: wú huǐ yì de
王后般地: wáng hòu bān de
为更好地: wèi gèng hǎo de
我高兴地: wǒ gāo xìng de
无光泽地: wú guāng zé de
无感觉地: wú gǎn jué de
无感情地: wú gǎn qíng de
外观上地: wài guān shàng de
外观好地: wài guān hǎo de
无节制地: wú jié zhì de
无价值地: wú jià zhí de
无见识地: wú jiàn shí de
无计划地: wú jì huà de
无技巧地: wú jì qiǎo de
无技术地: wú jì shù de
无经验地: wú jīng yàn de
未决定地: wèi jué deng de
无困难地: wú kùn nán de
无愧地说: wú kuì de shuō
挖苦地说: wā kǔ de shuō
未烤透地: wèi kǎo tòu de
无名声地: wú míng shēng de
顽皮地笑: wán pí de xiào
我奇怪地: wǒ qí guài de
委曲地说: wěi qū de shuō
委屈地说: wěi qū de shuō
委屈地哭: wěi qū de kū
无气力地: wú qì lì de
无穷尽地: wú qióng jìn de
无缺点地: wú quē diǎn de
无趣味地: wú qù wèi de
未期望地: wèi qī wàng de
无数次地: wú shù cì de
五十倍地: wǔ shí bèi de
无生气地: wú shēng qì de
无生命地: wú shēng mìng de
无思想地: wú sī xiǎng de
未受伤地: wèi shòu shāng de
往上游地: wǎng shàng yóu de
无条件地: wú tiáo jiàn de
我痛切地: wǒ tòng qiè de
委体于地: wěi tǐ yú de
无条理地: wú tiáo lǐ de
无添饰地: wú tiān shì de
无痛苦地: wú tòng kǔ de
未提炼地: wèi tí liàn de
呜呜地哭: wū wū de kū
呜呜地叫: wū wū de jiào
哇哇地哭: wā wā de kū
无污染地: wú wū rǎn de
无误地予: wú wù de yǔ
委婉地说: wěi wǎn de shuō
喂喂地叫: wèi wèi de jiào
嗡嗡地响: wēng wēng de xiǎng
无限制地: wú xiàn zhì de
无休止地: wú xiū zhǐ de
无希望地: wú xī wàng de
无限期地: wú xiàn qī de
我幸运地: wǒ xìng yùn de
威胁性地: wēi xié xìng de
微笑地说: wēi xiào de shuō
违心地做: wéi xīn de zuò
惋惜地说: wǎn xī de shuō
文学上地: wén xué shàng de
无兴趣地: wú xìng qù de
无血色地: wú xuè sè de
无信仰地: wú xìn yǎng de
无效率地: wú xiào lǜ de
无瑕疵地: wú xiá cī de
无意义地: wú yì yì de
无意识地: wú yì shí de
我勇敢地: wǒ yǒng gǎn de
无异议地: wú yì yì de
无掩饰地: wú yǎn shì de
无隐饰地: wú yǐn shì de
武扬威地: wǔ yáng wēi de
望远镜地: wàng yuǎn jìng de
我正确地: wǒ zhèng què de
我自豪地: wǒ zì háo de
委之于地: wěi zhī yú de
婉转地说: wǎn zhuǎn de shuō
文字上地: wén zì shàng de
无自信地: wú zì xìn de
无阻碍地: wú zǔ ài de
无宗教地: wú zōng jiào de
无知觉地: wú zhī jué de
无准备地: wú zhǔn bèi de
无症状地: wú zhèng zhuàng de
哇地一声: wa de yī shēng
嗡地一声: wēng de yī shēng
无定形地: wú deng xíng de
未戴帽地: wèi dài mào de
问答体地: wèn dá tǐ de
为难地说: wéi nán de shuō
无力地看: wú lì de kàn
我努力地: wǒ nǔ lì de
我理智地: wǒ lǐ zhì de
无力气地: wú lì qì de
无礼貌地: wú lǐ mào de
无耐性地: wú nài xìng de
无恶意地: wú è yì de
无能力地: wú néng lì de
无理性地: wú lǐ xìng de
无理智地: wú lǐ zhì de
无联络地: wú lián luò de
玩偶似地: wán ǒu shì de
无保留地: wú bǎo liú de
我不停地: wǒ bù tíng de
无把握地: wú bǎ wò de
无表情地: wú biǎo qíng de
无变化地: wú biàn huà de
无斑点地: wú bān diǎn de
外表上地: wài biǎo shàng de
未必然地: wèi bì rán de
未表明地: wèi biǎo míng de
无次序地: wú cì xù de
无诚意地: wú chéng yì de
无差别地: wú chā bié de
无慈悲地: wú cí bēi de
逃也似地: táo yě shì de
同样地大: tóng yàng de dà
特意地看: tè yì de kàn
椭圆形地: tuǒ yuán xíng de
天真地问: tiān zhēn de wèn
他自觉地: tā zì jué de
天真地说: tiān zhēn de shuō
他气愤地: tā qì fèn de
他亲切地: tā qīn qiè de
他悄悄地: tā qiāo qiāo de
他清醒地: tā qīng xǐng de
偷窃癖地: tōu qiè pǐ de
他失望地: tā shī wàng de
通俗地讲: tōng sú de jiǎng
同时着地: tóng shí zhe de
天设地造: tiān shè de zào
天使般地: tiān shǐ bān de
铁丝状地: tiě sī zhuàng de
提示性地: tí shì xìng de
偷偷地看: tōu tōu de kàn
偷偷地哭: tōu tōu de kū
偷偷地做: tōu tōu de zuò
甜甜地说: tián tián de shuō
甜甜地睡: tián tián de shuì
偷偷地走: tōu tōu de zǒu
滔滔地说: tāo tāo de shuō
他为难地: tā wéi nán de
他顽强地: tā wán qiáng de
她为难地: tā wéi nán de
同位素地: tóng wèi sù de
头向前地: tóu xiàng qián de
她羞愧地: tā xiū kuì de
挑衅似地: tiǎo xìn shì de
叹息地说: tàn xī de shuō
讨好地笑: tǎo hǎo de xiào
讨好人地: tǎo hǎo rén de
屠夫般地: tú fū bān de
天干地燥: tiān gān de zào
他果断地: tā guǒ duàn de
他高兴地: tā gāo xìng de
听教训地: tīng jiào xùn de
统计上地: tǒng jì shàng de
痛快地打: tòng kuài de dǎ
痛快地讲: tòng kuài de jiǎng
痛快地哭: tòng kuài de kū
痛苦地去: tòng kǔ de qù
痛苦地说: tòng kǔ de shuō
他明确地: tā míng què de
他茫然地: tā máng rán de
甜咪咪地: tián mī mī de
他频繁地: tā pín fán de
通盘地看: tōng pán de kàn
腾地一下: téng de yī xià
十字形地: shí zì xíng de
十字状地: shí zì zhuàng de
实质性地: shí zhì xìng de
说着谎地: shuō zhe huǎng de
说着谎地: shuō zhe huǎng de
他乐意地: tā lè yì de
他冷静地: tā lěng jìng de
坦率地说: tǎn shuài de shuō
坦率地谈: tǎn shuài de tán
贪婪地吃: tān lán de chī
贪婪地看: tān lán de kàn
特尔地木: tè ěr de mù
坦然地说: tǎn rán de shuō
贪婪地盯: tān lán de dīng
天不怕地: tiān bù pà de
他本能地: tā běn néng de
他不停地: tā bù tíng de
他不断地: tā bù duàn de
停不停地: tíng bù tíng de
逃不掉地: táo bù diào de
透不过地: tòu bù guò de
生硬地说: shēng yìng de shuō
死一般地: sǐ yì bān de
实验性地: shí yàn xìng de
深远地问: shēn yuǎn de wèn
十一倍地: shí yí bèi de
死一样地: sǐ yī yàng de
呻吟地说: shēn yín de shuō
实验式地: shí yàn shì de
试验性地: shì yàn xìng de
生气地说: shēng qì de shuō
似妻子地: shì qī zǐ de
飒飒地响: sà sà de xiǎng
三十倍地: sān shí bèi de
史诗式地: shǐ shī shì de
顺时针地: shùn shí zhēn de
飕飕地飞: sōu sōu de fēi
嘶嘶地响: sī sī de xiǎng
试探地问: shì tàn de wèn
生态型地: shēng tài xíng de
身体上地: shēn tǐ shàng de
斯文委地: sī wén wěi de
手挽手地: shǒu wǎn shǒu de
生物学地: shēng wù xué de
使无效地: shǐ wú xiào de
说玩笑地: shuō wán xiào de
散文式地: sǎn wén shì de
散文般地: sǎn wén bān de
上下文地: shàng xià wén de
色析法地: sè xī fǎ de
似旋涡地: shì xuán wō de
使陷危地: shǐ xiàn wēi de
思想上地: sī xiǎng shàng de
神学上地: shén xué shàng de
傻呵呵地: shǎ hē hē de
司法上地: sī fǎ shàng de
似合理地: shì hé lǐ de
似黄铜地: shì huáng tóng de
说反话地: shuō fǎn huà de
舒服地躺: shū fú de tǎng
煞风景地: shā fēng jǐng de
使感动地: shǐ gǎn dòng de
使劲地打: shǐ jìn de dǎ
撒娇地说: sā jiāo de shuō
社交上地: shè jiāo shàng de
使劲地干: shǐ jìn de gàn
使劲地嚼: shǐ jìn de jué
使窘迫地: shǐ jiǒng pò de
视觉上地: shì jué shàng de
受交友地: shòu jiāo yǒu de
爽快地说: shuǎng kuài de shuō
随口地唱: suí kǒu de chàng
受困惑地: shòu kùn huò de
神秘地说: shén mì de shuō
生命力地: shēng mìng lì de
使迷惑地: shǐ mí huò de
使麻木地: shǐ má mù de
审美上地: shěn měi shàng de
说明式地: shuō míng shì de
宿命论地: sù mìng lùn de
散慢地说: sàn màn de shuō
散漫地说: sǎn màn de shuō
审判上地: shěn pàn shàng de
傻呆呆地: shǎ dāi dāi de
闪电般地: shǎn diàn bān de
似地穿过: shì de chuān guò
刷地泛红: shuā de fàn hóng
实打实地: shí dǎ shí de
是多么地: shì duō me de
刷地一声: shuā de yī shēng
似毒蛇地: shì dú shé de
嗖地发射: sōu de fā shè
嗖地挥动: sōu de huī dòng
飕地挥舞: sōu de huī wǔ
少女似地: shào nǚ shì de
手拉手地: shǒu lā shǒu de
少量地吃: shǎo liàng de chī
生理学地: shēng lǐ xué de
收敛性地: shōu liǎn xìng de
死了似地: sǐ le shì de
似露水地: shì lù shuǐ de
湿淋淋地: shī lín lín de
十八层地: shí bā céng de
散步似地: sàn bù shì de
手不时地: shǒu bù shí de
时不时地: shí bù shí de
身不离地: shēn bù lí de
手把手地: shǒu bǎ shǒu de
四边形地: sì biān xíng de
守本分地: shǒu běn fèn de
似玻璃地: shì bō lí de
说不出地: shuō bù chū de
数不清地: shǔ bù qīng de
睡不着地: shuì bù zhe de
睡不着地: shuì bù zhe de
生存力地: shēng cún lì de
申斥似地: shēn chì shì de
受嘲弄地: shòu cháo nòng de
受嘲笑地: shòu cháo xiào de
深测术地: shēn cè shù de
破坏性地: pò huài xìng de
片分类地: piàn fēn lèi de
平静地说: píng jìng de shuō
片面地看: piàn miàn de kàn
批判性地: pī pàn xìng de
砰砰地跳: pēng pēng de tiào
劈啪地响: pī pā de xiǎng
批评性地: pī píng xìng de
砰砰地打: pēng pēng de dǎ
砰砰地敲: pēng pēng de qiāo
脾气坏地: pí qì huài de
蹒跚地走: pán shān de zǒu
排泄物地: pái xiè wù de
轻率地说: qīng shuài de shuō
却冷酷地: què lěng kù de
亲热地叫: qīn rè de jiào
亲热地说: qīn rè de shuō
却热情地: què rè qíng de
亲昵地说: qīn nì de shuō
勤劳地干: qín láo de gàn
千百年地: qiān bǎi nián de
瞧不起地: qiáo bù qǐ de
虔诚地说: qián chéng de shuō
清楚地说: qīng chǔ de shuō
气冲冲地: qì chōng chōng de
确地叙述: què de xù shù
气呼呼地: qì hū hū de
气愤地问: qì fèn de wèn
气愤地说: qì fèn de shuō
全方位地: quán fāng wèi de
气候上地: qì hòu shàng de
气鼓鼓地: qì gǔ gǔ de
却更多地: què gèng duō de
奇怪地问: qí guài de wèn
取高利地: qǔ gāo lì de
器官上地: qì guān shàng de
奇迹般地: qí jì bān de
却倔犟地: què juè jiàng de
起劲地笑: qǐ jìn de xiào
全景式地: quán jǐng shì de
起劲地干: qǐ jìn de gàn
轻快地飞: qīng kuài de fēi
轻快地走: qīng kuài de zǒu
轻快地唱: qīng kuài de chàng
轻蔑地笑: qīng miè de xiào
巧妙地将: qiǎo miào de jiāng
全面地看: quán miàn de kàn
却默默地: què mò mò de
浅明地说: qiǎn míng de shuō
起泡沫地: qǐ pào mò de
强迫人地: qiǎng pò rén de
轻轻地问: qīng qīng de wèn
却清楚地: què qīng chǔ de
怯怯地答: qiè qiè de dá
亲切地叫: qīn qiè de jiào
亲切地交: qīn qiè de jiāo
亲切地问: qīn qiè de wèn
亲切地呼: qīn qiè de hū
轻轻地抓: qīng qīng de zhuā
轻轻地将: qīng qīng de jiāng
轻轻地说: qīng qīng de shuō
轻轻地舀: qīng qīng de yǎo
轻轻着地: qīng qīng zhe de
悄悄地听: qiāo qiāo de tīng
确切地讲: què qiè de jiǎng
确切地说: què qiè de shuō
亲切地说: qīn qiè de shuō
轻轻地摇: qīng qīng de yáo
轻轻地飘: qīng qīng de piāo
瞿瞿地叫: qú qú de jiào
轻轻地讲: qīng qīng de jiǎng
轻轻地吹: qīng qīng de chuī
轻轻地走: qīng qīng de zǒu
却深深地: què shēn shēn de
轻声地说: qīng shēng de shuō
轻松地做: qīng sōng de zuò
轻声地讲: qīng shēng de jiǎng
轻松地笑: qīng sōng de xiào
七十倍地: qī shí bèi de
轻声地走: qīng shēng de zǒu
确实性地: què shí xìng de
庆幸地说: qìng xìng de shuō
强有力地: qiáng yǒu lì de
轻悠悠地: qīng yōu yōu de
契约上地: qì yuē shàng de
愀洋洋地: qiǎo yáng yáng de
趋药性地: qū yào xìng de
潜意识地: qián yì shí de
却整齐地: què zhěng qí de
强制性地: qiáng zhì xìng de
妻子似地: qī zǐ shì de
妻子般地: qī zǐ bān de
前置词地: qián zhì cí de
疲累地走: pí lèi de zǒu
砰然地响: pēng rán de xiǎng
攀良似地: pān liáng shì de
攀敛性地: pān liǎn xìng de
凭触觉地: píng chù jué de
美滋滋地: měi zī zī de
满足地看: mǎn zú de kàn
没好气地: méi hǎo qì de
迷惑地问: mí huò de wèn
蛮横地说: mán hèng de shuō
马虎地做: mǎ hǔ de zuò
民法上地: mín fǎ shàng de
每分钟地: měi fēn zhōng de
没防备地: méi fáng bèi de
冒风险地: mào fēng xiǎn de
梦幻般地: mèng huàn bān de
蛮横地拖: mán hèng de tuō
蛮横地喊: mán hèng de hǎn
魔法似地: mó fǎ shì de
猛孤丁地: měng gū dīng de
没规矩地: méi guī jǔ de
牧歌般地: mù gē bān de
魔鬼似地: mó guǐ shì de
魔鬼般地: mó guǐ bān de
没教养地: méi jiào yǎng de
没精神地: méi jīng shén de
没考虑地: méi kǎo lǜ de
没命地跑: méi mìng de pǎo
汨汨地流: mì mì de liú
卖命地干: mài mìng de gàn
茫茫然地: máng máng rán de
慢慢地好: màn màn de hǎo
慢慢地谈: màn màn de tán
默默地想: mò mò de xiǎng
民民有地: mín mín yǒu de
没目标地: méi mù biāo de
咪咪地叫: mī mī de jiào
哞哞地叫: mōu mōu de jiào
慢慢地走: màn màn de zǒu
慢慢地煮: màn màn de zhǔ
勉强地在: miǎn qiǎng de zài
毛求疵地: máo qiú cī de
明确地说: míng què de shuō
没气力地: méi qì lì de
磨石子地: mó shí zi de
每三年地: měi sān nián de
没受伤地: méi shòu shāng de
摸索着地: mō suǒ zhe de
魔术般地: mó shù bān de
没头脑地: méi tóu nǎo de
弥天亘地: mí tiān gèn de
慢吞吞地: màn tūn tūn de
慢腾腾地: màn téng téng de
腼腆地说: miǎn tiǎn de shuō
腼腆地笑: miǎn tiǎn de xiào
每小时地: měi xiǎo shí de
满意地说: mǎn yì de shuō
慢悠悠地: màn yōu yōu de
满意地笑: mǎn yì de xiào
名义上地: míng yì shàng de
每音节地: měi yīn jié de
谜一般地: mí yì bān de
面对面地: miàn duì miàn de
猛地一拉: měng de yī lā
猛地扑打: měng de pū dǎ
猛地扑到: měng de pū dào
猛地向上: měng de xiàng shàng
猛地闯入: měng de chuǎng rù
猛地抓住: měng de zhuā zhù
猛地往下: měng de wǎng xià
猛地想来: měng de xiǎng lái
猛地想起: měng de xiǎng qǐ
猛地醒觉: měng de xǐng jué
麻地敖包: má de áo bāo
猛地一动: měng de yī dòng
猛地一愣: měng de yī lèng
猛地发现: měng de fā xiàn
漫地匝地: màn de zā de
猛地扔下: měng de rēng xià
猛地落下: měng de là xià
猛地一把: měng de yī bǎ
猛地站起: měng de zhàn qǐ
名词性地: míng cí xìng de
没出息地: méi chū xī de
空前地多: kōng qián de duō
肯切地说: kěn qiè de shuō
恳切地说: kěn qiè de shuō
恳求地说: kěn qiú de shuō
可劝告地: kě quàn gào de
可区分地: kě qū fēn de
可区别地: kě qū bié de
可取代地: kě qǔ dài de
可钦佩地: kě qīn pèi de
狂犬病地: kuáng quǎn bìng de
客气地说: kè qì de shuō
哭泣地说: kū qì de shuō
恳求似地: kěn qiú shì de
快速地跑: kuài sù de pǎo
可实行地: kě shí xíng de
可说明地: kě shuō míng de
哭天嚎地: kū tiān háo de
狂天说地: kuáng tiān shuō de
垦拓荒地: kěn tuò huāng de
口头上地: kǒu tóu shàng de
卡塔地响: kǎ tǎ de xiǎng
可替换地: kě tì huàn de
哭天哭地: kū tiān kū de
开玩笑地: kāi wán xiào de
开心地说: kāi xīn de shuō
开心地笑: kāi xīn de xiào
可享乐地: kě xiǎng lè de
可信任地: kě xìn rèn de
可信赖地: kě xìn lài de
可选择地: kě xuǎn zé de
可悬吊地: kě xuán diào de
可旋转地: kě xuán zhuǎn de
可想象地: kě xiǎng xiàng de
可想像地: kě xiǎng xiàng de
刻意地去: kè yì de qù
可依赖地: kě yī lài de
可拥护地: kě yōng hù de
可原谅地: kě yuán liàng de
可预料地: kě yù liào de
可移动地: kě yí dòng de
抗议地说: kàng yì de shuō
苦役般地: kǔ yì bān de
溃疡性地: kuì yáng xìng de
可争辩地: kě zhēng biàn de
可中止地: kě zhōng zhǐ de
可支持地: kě zhī chí de
可折射地: kě zhé shè de
可证明地: kě zhèng míng de
可治疗地: kě zhì liáo de
可知觉地: kě zhī jué de
可转动地: kě zhuàn dòng de
可着色地: kě zhe sè de
可着色地: kě zhe sè de
可尊敬地: kě zūn jìng de
可憎恶地: kě zēng è de
可赞赏地: kě zàn shǎng de
夸张地说: kuā zhāng de shuō
马尔地夫: mǎ ěr de fū
没来由地: méi lái yóu de
茫然地看: máng rán de kàn
猛力踩地: měng lì cǎi de
猛烈地刮: měng liè de guā
马拉地语: mǎ lā de yǔ
名狼藉地: míng láng jí de
没礼貌地: méi lǐ mào de
命令式地: mìng lìng shì de
媒染剂地: méi rǎn jì de
媒染性地: méi rǎn xìng de
明白地说: míng bái de shuō
每半年地: měi bàn nián de
每百年地: měi bǎi nián de
困惑地问: kùn huò de wèn
可分别地: kě fēn bié de
可分离地: kě fēn lí de
可反对地: kě fǎn duì de
可反驳地: kě fǎn bó de
可防御地: kě fáng yù de
康复中地: kāng fù zhōng de
可改变地: kě gǎi biàn de
可更好地: kě gèng hǎo de
刻骨地爱: kè gǔ de ài
客观地看: kè guān de kàn
可公开地: kě gōng kāi de
可估价地: kě gū jià de
可较好地: kě jiào hǎo de
可计算地: kě jì suàn de
可节省地: kě jié shěng de
可交换地: kě jiāo huàn de
可接近地: kě jiē jìn de
可救济地: kě jiù jì de
可扩张地: kě kuò zhāng de
可肯定地: kě kěn deng de
可宽恕地: kě kuān shù de
空孔状地: kōng kǒng zhuàng de
苦苦地干: kǔ kǔ de gàn
可目视地: kě mù shì de
可明言地: kě míng yán de
可评价地: kě píng jià de
可单独地: kě dān dú de
肯定地说: kěn deng de shuō
卡地根郡: kǎ de gēn jùn
可动性地: kě dòng xìng de
可点数地: kě diǎn shù de
可断言地: kě duàn yán de
可断定地: kě duàn deng de
均匀地涂: jūn yún de tú
进一步地: jìn yí bù de
将有效地: jiāng yǒu xiào de
兼有其地: jiān yǒu qí de
惊讶地说: jīng yà de shuō
箭也似地: jiàn yě shì de
紧张地说: jǐn zhāng de shuō
狡诈地笑: jiǎo zhà de xiào
脚着地时: jiǎo zhe de shí
就自动地: jiù zì dòng de
交战中地: jiāo zhàn zhōng de
讲真话地: jiǎng zhēn huà de
极准时地: jí zhǔn shí de
建筑上地: jiàn zhù shàng de
假正经地: jiǎ zhèng jīng de
精制地蜡: jīng zhì de là
可认识地: kě rèn shí de
可让出地: kě ràng chū de
可列举地: kě liè jǔ de
可论证地: kě lùn zhèng de
可忍受地: kě rěn shòu de
可忍耐地: kě rěn nài de
可怜悯地: kě lián mǐn de
可饶恕地: kě ráo shù de
可容许地: kě róng xǔ de
可容忍地: kě róng rěn de
可爱地仃: kě ài de dīng
可理解地: kě lǐ jiě de
可比较地: kě bǐ jiào de
可驳斥地: kě bó chì de
可保卫地: kě bǎo wèi de
可变通地: kě biàn tōng de
可被选地: kě bèi xuǎn de
可辨别地: kě biàn bié de
可辩护地: kě biàn hù de
可辩解地: kě biàn jiě de
看不见地: kàn bú jiàn de
看不出地: kàn bù chū de
靠不住地: kào bú zhù de
口吃地说: kǒu chī de shuō
空场闲地: kōng chǎng xián de
口才好地: kǒu cái hǎo de
可承认地: kě chéng rèn de
可承诺地: kě chéng nuò de
可崇敬地: kě chóng jìng de
可触知地: kě chù zhī de
可察觉地: kě chá jué de
看穿了地: kàn chuān le de
就明显地: jiù míng xiǎn de
急忙地讲: jí máng de jiǎng
近旁地在: jìn páng de zài
尽情地谈: jìn qíng de tán
就轻轻地: jiù qīng qīng de
就悄悄地: jiù qiāo qiāo de
精确地说: jīng què de shuō
静悄悄地: jìng qiāo qiāo de
尖声地叫: jiān shēng de jiào
急速地跳: jí sù de tiào
就顺利地: jiù shùn lì de
沮丧地说: jǔ sàng de shuō
尖声地说: jiān shēng de shuō
技术上地: jì shù shàng de
技术好地: jì shù hǎo de
建设性地: jiàn shè xìng de
经衰弱地: jīng shuāi ruò de
急速地念: jí sù de niàn
急速地说: jí sù de shuō
竞赛性地: jìng sài xìng de
矫饰地做: jiǎo shì de zuò
精神上地: jīng shén shàng de
击天抓地: jī tiān zhuā de
具体地说: jù tǐ de shuō
极天爬地: jí tiān pá de
阶梯式地: jiē tī shì de
极痛苦地: jí tòng kǔ de
家庭式地: jiā tíng shì de
极紊乱地: jí wěn luàn de
近尾部地: jìn wěi bù de
机械地做: jī xiè de zuò
将相应地: jiàng xiàng yīng de
假腥腥地: jiǎ xīng xīng de
惊喜地说: jīng xǐ de shuō
就细致地: jiù xì zhì de
惊喜地问: jīng xǐ de wèn
就鲜明地: jiù xiān míng de
记性好地: jì xìng hǎo de
极详细地: jí xiáng xì de
尽可能地: jìn kě néng de
尽快地唱: jǐn kuài de chàng
艰苦地干: jiān kǔ de gàn
极快地说: jí kuài de shuō
渐渐地大: jiàn jiàn de dà
渐渐地小: jiàn jiàn de xiǎo
脚尖点地: jiǎo jiān diǎn de
脚尖着地: jiǎo jiān zhe de
就急急地: jiù jí jí de
就渐渐地: jiù jiàn jiàn de
静静地听: jìng jìng de tīng
极均衡地: jí jūn héng de
极谨慎地: jí jǐn shèn de
季节性地: jì jié xìng de
经济学地: jīng jì xué de
唧唧地叫: jī jī de jiào
警句式地: jǐng jù shì de
就飞快地: jiù fēi kuài de
几何学地: jǐ hé xué de
交互式地: jiāo hù shì de
经分析地: jīng fēn xī de
经分解地: jīng fēn jiě de
较合适地: jiào hé shì de
就尴尬地: jiù gān gà de
坚决地说: jiān jué de shuō
决定性地: jué deng xìng de
绝对地说: jué duì de shuō
简单地讲: jiǎn dān de jiǎng
简单地说: jiǎn dān de shuō
激动地说: jī dòng de shuō
讲道理地: jiǎng dào lǐ de
娇滴滴地: jiāo dī dī de
就大大地: jiù dà dà de
坚定地说: jiān deng de shuō
局部性地: jú bù xìng de
基本上地: jī běn shàng de
禁不住地: jīn bú zhù de
金城池地: jīn chéng chí de
金城汤地: jīn chéng tāng de
急促地说: jí cù de shuō
经承认地: jīng chéng rèn de
急促地谈: jí cù de tán
锯齿形地: jù chǐ xíng de
艰难地走: jiān nán de zǒu
将理性地: jiāng lǐ xìng de
紧挨着地: jǐn āi zhe de
接连地打: jiē lián de dǎ
激昂地说: jī áng de shuō
机能上地: jī néng shàng de
具理解地: jù lǐ jiě de
肩并肩地: jiān bìng jiān de
痉挛性地: jìng luán xìng de
公正地说: gōng zhèng de shuō
更正确地: gēng zhèng què de
更自觉地: gèng zì jué de
固执地说: gù zhí de shuō
供展览地: gōng zhǎn lǎn de
该诅咒地: gāi zǔ zhòu de
贵族似地: guì zú shì de
贵族般地: guì zú bān de
嘎吱地响: gā zhī de xiǎng
更深入地: gēng shēn rù de
共事务地: gòng shì wù de
感天泣地: gǎn tiān qì de
怪天怪地: guài tiān guài de
感叹地说: gǎn tàn de shuō
国王似地: guó wáng shì de
公务上地: gōng wù shàng de
怪物似地: guài wù shì de
更雄伟地: gèng xióng wěi de
高兴地从: gāo xìng de cóng
高兴地说: gāo xìng de shuō
高兴地笑: gāo xìng de xiào
高兴地喊: gāo xìng de hǎn
关系词地: guān xì cí de
更向前地: gèng xiàng qián de
更辛苦地: gèng xīn kǔ de
更详细地: gèng xiáng xì de
骨相学地: gǔ xiāng xué de
广义地说: guǎng yì de shuō
更有力地: gèng yǒu lì de
更有效地: gèng yǒu xiào de
更愉快地: gèng yú kuài de
更严重地: gèng yán zhòng de
概括地说: gài kuò de shuō
公开地讲: gōng kāi de jiǎng
公开地说: gōng kāi de shuō
感慨地说: gǎn kǎi de shuō
更可取地: gèng kě qǔ de
概括地讲: gài kuò de jiǎng
概括性地: gài kuò xìng de
公平地说: gōng píng de shuō
关切地问: guān qiè de wèn
更全面地: gèng quán miàn de
够气派地: gòu qì pài de
感情上地: gǎn qíng shàng de
更确切地: gèng què qiè de
乖乖地听: guāi guāi de tīng
呱呱地叫: gū gū de jiào
咕咕地叫: gū gū de jiào
咯咯地笑: gē gē de xiào
格格地笑: gé gé de xiào
尴尬地笑: gān gà de xiào
格格地响: gé gé de xiǎng
咯咯地叫: gē gē de jiào
格格地咬: gé gé de yǎo
格格地嚼: gé gé de jué
鸪鸪地叫: gū gū de jiào
嘎嘎地叫: gā gā de jiào
嘎嘎地响: gā gā de xiǎng
更坚决地: gèng jiān jué de
更精确地: gèng jīng què de
恭敬地送: gōng jìng de sòng
感激地说: gǎn jī de shuō
过节似地: guò jié shì de
国际性地: guó jì xìng de
感觉上地: gǎn jué shàng de
感觉到地: gǎn jué dào de
更好地为: gèng hǎo de wèi
过分地做: guò fèn de zuò
更缓慢地: gèng huǎn màn de
更多地是: gèng duō de shì
更粗劣地: gèng cū liè de
高采烈地: gāo cǎi liè de
更恶劣地: gèng è liè de
拱廊似地: gǒng láng shì de
高利贷地: gāo lì dài de
攻不破地: gōng bù pò de
干巴巴地: gān bā bā de
根本上地: gēn běn shàng de
更不幸地: gèng bù xìng de
会准确地: huì zhǔn què de
孩子似地: hái zi shì de
很自然地: hěn zì rán de
很准确地: hěn zhǔn què de
猴子似地: hóu zi shì de
反宗教地: fǎn zōng jiào de
发作性地: fā zuò xìng de
好争吵地: hǎo zhēng chǎo de
红着脸地: hóng zhe liǎn de
红着脸地: hóng zhe liǎn de
放纵地笑: fàng zòng de xiào
非正式地: fēi zhèng shì de
非正统地: fēi zhèng tǒng de
非正常地: fēi zhèng cháng de
非宗教地: fēi zōng jiào de
非政治地: fēi zhèng zhì de
孩子气地: hái zi qì de
疯子似地: fēng zi shì de
孤零零地: gū líng líng de
过了头地: guò le tóu de
孤立地看: gū lì de kàn
孤立地说: gū lì de shuō
高傲地说: gāo ào de shuō
骨碌碌地: gū lù lù de
烦天恼地: fán tiān nǎo de
还突出地: hái tū chū de
还甜甜地: hái tián tián de
很投入地: hěn tóu rù de
很突然地: hěn tū rán de
风土性地: fēng tǔ xìng de
好挑剔地: hǎo tiāo tī de
沸腾着地: fèi téng zhe de
很委婉地: hěn wěi wǎn de
放心地做: fàng xīn de zuò
回旋地飞: huí xuán de fēi
诙谐地说: huī xié de shuō
很辛苦地: hěn xīn kǔ de
很详细地: hěn xiáng xì de
很响亮地: hěn xiǎng liàng de
分虚伪地: fēn xū wěi de
好嬉戏地: hǎo xī xì de
负向地地: fù xiàng de de
坏心眼地: huài xīn yǎn de
飞也似地: fēi yě shì de
还愉快地: hái yú kuài de
虎咽地吃: hǔ yàn de chī
很隐敝地: hěn yǐn bì de
反应性地: fǎn yìng xìng de
怀疑性地: huái yí xìng de
黑黝黝地: hēi yǒu yǒu de
缓慢地走: huǎn màn de zǒu
缓慢地说: huǎn màn de shuō
缓慢地流: huǎn màn de liú
毁灭似地: huǐ miè shì de
很便宜地: hěn pián yí de
好批评地: hǎo pī píng de
衡平法地: héng píng fǎ de
风趣地说: fēng qù de shuō
还清晰地: huán qīng xī de
很轻松地: hěn qīng sōng de
很轻蔑地: hěn qīng miè de
很谦恭地: hěn qiān gōng de
夫妻间地: fū qī jiān de
好奇地听: hào qí de tīng
花腔音地: huā qiāng yīn de
富情感地: fù qíng gǎn de
非社会地: fēi shè huì de
和善地问: hé shàn de wèn
放声地哭: fàng shēng de kū
放肆地笑: fàng sì de xiào
洪水似地: hóng shuǐ shì de
活生生地: huó shēng shēng de
很顺利地: hěn shùn lì de
火山似地: huǒ shān shì de
华俗气地: huá sú qì de
合时令地: hé shí lìng de
合时宜地: hé shí yí de
怀熟虑地: huái shú lǜ de
放射状地: fàng shè zhuàng de
放射镜地: fàng shè jìng de
腐蚀性地: fǔ shí xìng de
哈哈地笑: hā hā de xiào
恨恨地说: hèn hèn de shuō
好好地吃: hǎo hǎo de chī
嘿嘿地笑: hēi hēi de xiào
反复地做: fǎn fù de zuò
好好地练: hǎo hǎo de liàn
还好好地: hái hǎo hǎo de
狠狠地说: hěn hěn de shuō
愤愤地说: fèn fèn de shuō
繁华旺地: fán huá wàng de
分华丽地: fēn huá lì de
反方向地: fǎn fāng xiàng de
反复地说: fǎn fù de shuō
反覆地讲: fǎn fù de jiǎng
夫妇般地: fū fù bān de
好和平地: hǎo hé píng de
灰黄色地: huī huáng sè de
含混地说: hán hùn de shuō
含糊地发: hán hú de fā
含糊地念: hán hú de niàn
含糊地说: hán hú de shuō
怀负义地: huái fù yì de
厚厚地涂: hòu hòu de tú
哗哗地流: huā huā de liú
狠狠地打: hěn hěn de dǎ
绘画般地: huì huà bān de
黄喉地莺: huáng hóu de yīng
很尴尬地: hěn gān gà de
分光镜地: fēn guāng jìng de
反过来地: fǎn guò lái de
非公认地: fēi gōng rèn de
非固有地: fēi gù yǒu de
非官办地: fēi guān bàn de
非官方地: fēi guān fāng de
非故意地: fēi gù yì de
富感情地: fù gǎn qíng de
会骄傲地: huì jiāo ào de
非经常地: fēi jīng cháng de
很均匀地: hěn jūn yún de
很沮丧地: hěn jǔ sàng de
很紧密地: hěn jǐn mì de
很惊奇地: hěn jīng qí de
很简单地: hěn jiǎn dān de
福建省地: fú jiàn shěng de
分阶段地: fēn jiē duàn de
好交际地: hǎo jiāo jì de
好竞争地: hǎo jìng zhēng de
好嫉妒地: hǎo jí dù de
环境上地: huán jìng shàng de
飞快地跑: fēi kuài de pǎo
发狂似地: fā kuáng shì de
欢快地跳: huān kuài de tiào
很快地飞: hěn kuài de fēi
很快地写: hěn kuài de xiě
很快地流: hěn kuài de liú
很客气地: hěn kè qì de
飞快地走: fēi kuài de zǒu
很可怕地: hěn kě pà de
疯狂似地: fēng kuáng shì de
患溃疡地: huàn kuì yáng de
很明白地: hěn míng bái de
很明显地: hěn míng xiǎn de
很茫然地: hěn máng rán de
很满意地: hěn mǎn yì de
虎地坳道: hǔ de ào dào
很大方地: hěn dà fāng de
嚯地站起: huò de zhàn qǐ
会凋零地: huì diāo líng de
好打听地: hǎo dǎ tīng de
怀敌意地: huái dí yì de
轰地一声: hōng de yī shēng
非典型地: fēi diǎn xíng de
非常多地: fēi cháng duō de
非常快地: fēi cháng kuài de
很残酷地: hěn cán kù de
反常情地: fǎn cháng qíng de
会传染地: huì chuán rǎn de
非常好地: fēi cháng hǎo de
发呆似地: fā dāi shì de
灰溜溜地: huī liū liū de
和蔼地说: hé ǎi de shuō
很认真地: hěn rèn zhēn de
很努力地: hěn nǔ lì de
愤怒地说: fèn nù de shuō
火辣辣地: huǒ là là de
发柔光地: fā róu guāng de
犯了罪地: fàn le zuì de
怀恶意地: huái è yì de
法律上地: fǎ lǜ shàng de
轰隆地响: hōng lōng de xiǎng
非难似地: fēi nàn shì de
厚脸皮地: hòu liǎn pí de
费力地找: fèi lì de zhǎo
患热病地: huàn rè bìng de
富人情地: fù rén qíng de
滑溜溜地: huá liū liū de
腐烂了地: fǔ làn le de
会不断地: huì bù duàn de
很不幸地: hěn bù xìng de
还不时地: hái bù shí de
还不断地: hái bù duàn de
德州地区: dé zhōu de qū
都自觉地: dōu zì jué de
倒栽葱地: dǎo zāi cōng de
大雨般地: dà yǔ bān de
动摇着地: dòng yáo zhe de
到远方地: dào yuǎn fāng de
断续性地: duàn xù xìng de
动物学地: dòng wù xué de
帝王般地: de wáng bān de
大踏步地: dà tà bù de
大声地说: dà shēng de shuō
大声地叫: dà shēng de jiào
大声地讲: dà shēng de jiǎng
大声地笑: dà shēng de xiào
大声地喊: dà shēng de hǎn
大声地嚼: dà shēng de jué
低声地讲: dī shēng de jiǎng
低声地哭: dī shēng de kū
都深深地: dōu shēn shēn de
登上陆地: dēng shàng lù de
短时间地: duǎn shí jiān de
到水中地: dào shuǐ zhōng de
定时性地: deng shí xìng de
多情地笑: duō qíng de xiào
大面积地: dà miàn jī de
调皮地说: tiáo pí de shuō
党派性地: dǎng pài xìng de
大口地喝: dà kǒu de hē
大口地吃: dà kǒu de chī
大口地吞: dà kǒu de tūn
大规模地: dà guī mó de
牢牢地粘住: láo láo de zhān zhù
日日夜夜地: rì rì yè yè de
令人不安地: lìng rén bù ān de
令人信服地: lìng rén xìn fú de
令人畏惧地: lìng rén wèi jù de
令人钦佩地: lìng rén qīn pèi de
令人难忘地: lìng rén nán wàng de
令人惊讶地: lìng rén jīng yà de
令人愉快地: lìng rén yú kuài de
令人满意地: lìng rén mǎn yì de
来来往往地: lái lái wǎng wǎng de
隆隆地行进: lóng lóng de xíng jìn
日复一日地: rì fù yí rì de
年复一年地: nián fù yī nián de
如何更好地: rú hé gèng hǎo de
如饥似渴地: rú jī sì kě de
热情地握手: rè qíng de wò shǒu
连续不断地: lián xù bù duàn de
日以继夜地: rì yǐ jì yè de
若有所思地: ruò yǒu suǒ sī de
难以相信地: nán yǐ xiāng xìn de
难以置信地: nán yǐ zhì xìn de
懒洋洋地说: lǎn yáng yáng de shuō
日益增长地: rì yì zēng zhǎng de
认真地工作: rèn zhēn de gōng zuò
不断地提高: bù duàn de tí gāo
不断地减小: bù duàn de jiǎn xiǎo
不断地供给: bù duàn de gōng jǐ
不断地请求: bù duàn de qǐng qiú
不断地探索: bù duàn de tàn suǒ
不断地播出: bù duàn de bō chū
不断地鼓掌: bù duàn de gǔ zhǎng
暴风雨般地: bào fēng yǔ bān de
不顾一切地: bù gù yī qiè de
不敢大胆地: bù gǎn dà dǎn de
不敢丝毫地: bù gǎn sī háo de
卑恭屈节地: bēi gōng qū jié de
不解地问道: bù jiě de wèn dào
不加深究地: bù jiā shēn jiū de
不可改变地: bù kě gǎi biàn de
不可变更地: bù kě biàn gēng de
不可避免地: bù kě bì miǎn de
不停地射出: bù tíng de shè chū
不停地射击: bù tíng de shè jī
不停地转动: bù tíng de zhuàn dòng
不停地颤抖: bù tíng de chàn dǒu
不惜工本地: bù xī gōng běn de
不住地后退: bú zhù de hòu tuì
不知怎么地: bù zhī zěn me de
不知不觉地: bù zhī bù jué de
抱着希望地: bào zhe xī wàng de
笨拙地爬行: bèn zhuō de pá xíng
才能更好地: cái néng gèng hǎo de
粗略地阅读: cū lüè de yuè dú
成倍地增长: chéng bèi de zēng zhǎng
匆匆地看看: cōng cōng de kàn kàn
充分地反映: chōng fèn de fǎn yìng
充满深情地: chōng mǎn shēn qíng de
吹毛求疵地: chuī máo qiú cī de
持续地工作: chí xù de gōng zuò
诚心诚意地: chéng xīn chéng yì de
沉重地行走: chén zhòng de xíng zǒu
躲避不了地: duǒ bì bù liǎo de
颠簸地行进: diān bǒ de xíng jìn
颠簸地行驶: diān bǒ de xíng shǐ
大大地露脸: dà dà de lòu liǎn
呆呆地看着: dāi dāi de kàn zhe
断断续续地: duàn duàn xù xù de
大胆地思考: dà dǎn de sī kǎo
平地起波澜: píng de qǐ bō lán
意思相反地: yì sī xiāng fǎn de
有吸引力地: yǒu xī yǐn lì de
有效地防止: yǒu xiào de fáng zhǐ
有益健康地: yǒu yì jiàn kāng de
洋洋得意地: yáng yáng dé yì de
一字不变地: yī zì bù biàn de
又在不停地: yòu zài bù tíng de
由衷地感谢: yóu zhōng de gǎn xiè
有针对性地: yǒu zhēn duì xìng de
样子瞥脚地: yàng zi piē jiǎo de
由衷地赞美: yóu zhōng de zàn měi
自然而然地: zì rán ér rán de
拙劣地工作: zhuō liè de gōng zuò
站得远远地: zhàn dé yuǎn yuǎn de
得意洋洋地: dé yì yáng yáng de
拽得紧紧地: zhuāi dé jǐn jǐn de
很得意地说: hěn dé yì de shuō
得意地笑了: dé yì de xiào le
得意地笑着: dé yì de xiào zhe
得意地笑笑: dé yì de xiào xiào
尽量地得到: jǐn liàng de dé dào
得意洋洋地: dé yì yáng yáng de
冷不丁地就: lěng bù dīng de jiù
慢慢地变老: màn màn de biàn lǎo
慢慢地渗透: màn màn de shèn tòu
能否准确地: néng fǒu zhǔn què de
迫不及待地: pò bù jí dài de
清楚地显示: qīng chǔ de xiǎn shì
忍不住地想: rěn bú zhù de xiǎng
如果一味地: rú guǒ yī wèi de
深刻地调查: shēn kè de diào chá
爽朗地笑声: shuǎng lǎng de xiào shēng
肆无忌惮地: sì wú jì dàn de
坦率地说吧: tǎn shuài de shuō ba
统统地杀光: tǒng tǒng de shā guāng
无缘无故地: wú yuán wú gù de
现在仔细地: xiàn zài zǐ xì de
兴致勃勃地: xìng zhì bó bó de
要狠狠地吃: yào hěn hěn de chī
隐隐约约地: yǐn yǐn yuē yuē de
愉悦地心情: yú yuè de xīn qíng
远远地看着: yuǎn yuǎn de kàn zhe
正确地教导: zhèng què de jiào dǎo
正确地推销: zhèng què de tuī xiāo
只是一味地: zhǐ shì yī wèi de
仔仔细细地: zǎi zǐ xì xì de
不断地尝试: bù duàn de cháng shì
不断地淬炼: bù duàn de cuì liàn
不断地淬取: bù duàn de cuì qǔ
不断地发现: bù duàn de fā xiàn
不断地发展: bù duàn de fā zhǎn
不断地反省: bù duàn de fǎn xǐng
不断地努力: bù duàn de nǔ lì
不断地适应: bù duàn de shì yìng
不断地完善: bù duàn de wán shàn
不断地追求: bù duàn de zhuī qiú
不停地大笑: bù tíng de dà xiào
不停地宣泄: bù tíng de xuān xiè
不停地涌现: bù tíng de yǒng xiàn
大胆地表白: dà dǎn de biǎo bái
大胆地表示: dà dǎn de biǎo shì
大声地尖叫: dà shēng de jiān jiào
多多地牵手: duō duō de qiān shǒu
虎视眈眈地: hǔ shì dān dān de
紧紧地贴住: jǐn jǐn de tiē zhù
紧紧地贴着: jǐn jǐn de tiē zhe
紧紧地吸附: jǐn jǐn de xī fù
紧紧地吸住: jǐn jǐn de xī zhù
静静地看看: jìng jìng de kàn kàn
清楚地表现: qīng chǔ de biǎo xiàn
确确实实地: què què shí shí de
一劳永逸地: yì láo yǒng yì de
勇敢地面对: yǒng gǎn de miàn duì
不满意地说: bù mǎn yì de shuō
十分地矛盾: shí fēn de máo dùn
相当地完善: xiāng dāng de wán shàn
迅速地拉近: xùn sù de lā jìn
那就大大地: nà jiù dà dà de
不是一般地: bú shì yì bān de
从未真正地: cóng wèi zhēn zhèng de
活活地拆散: huó huó de chāi sàn
更好地引导: gèng hǎo de yǐn dǎo
慢慢地长大: màn màn de zhǎng dà
悄悄地离开: qiāo qiāo de lí kāi
顺利地进行: shùn lì de jìn xíng
不停地骚扰: bù tíng de sāo rǎo
不能很好地: bù néng hěn hǎo de
不停地变化: bù tíng de biàn huà
大大地不同: dà dà de bù tóng
很坚决地说: hěn jiān jué de shuō
更快地输入: gèng kuài de shū rù
惊喜地发现: jīng xǐ de fā xiàn
可以轻松地: kě yǐ qīng sōng de
可以更好地: kě yǐ gèng hǎo de
静静地站着: jìng jìng de zhàn zhe
没有认真地: méi yǒu rèn zhēn de
很好地解决: hěn hǎo de jiě jué
最大可能地: zuì dà kě néng de
方便地制作: fāng biàn de zhì zuò
更好地把握: gèng hǎo de bǎ wò
可以方便地: kě yǐ fāng biàn de
没有过多地: méi yǒu guò duō de
痴痴地望着: chī chī de wàng zhe
错误地认为: cuò wù de rèn wéi
懒洋洋地问: lǎn yáng yáng de wèn
紧紧地抱着: jǐn jǐn de bào zhe
深深地吸气: shēn shēn de xī qì
不夸张地说: bù kuā zhāng de shuō
为了更好地: wèi le gèng hǎo de
彻底地消失: chè dǐ de xiāo shī
可以适当地: kě yǐ shì dàng de
淡淡地回答: dàn dàn de huí dá
顺利地通过: shùn lì de tōng guò
更快地找到: gèng kuài de zhǎo dào
重重地摔在: zhòng zhòng de shuāi zài
缓缓地摇头: huǎn huǎn de yáo tóu
更好地兼容: gèng hǎo de jiān róng
尽可能地多: jìn kě néng de duō
随心所欲地: suí xīn suǒ yù de
担心地看着: dān xīn de kàn zhe
乖乖地睡觉: guāi guāi de shuì jiào
好奇地看着: hào qí de kàn zhe
更好地使用: gèng hǎo de shǐ yòng
健康地发展: jiàn kāng de fā zhǎn
可以很好地: kě yǐ hěn hǎo de
全都乖乖地: quán dōu guāi guāi de
最大程度地: zuì dà chéng dù de
安静地离开: ān jìng de lí kāi
不必过多地: bù bì guò duō de
可以自由地: kě yǐ zì yóu de
无法真正地: wú fǎ zhēn zhèng de
有力地打击: yǒu lì de dǎ jī
应有意识地: yīng yǒu yì shí de
尽可能地去: jìn kě néng de qù
更好地实现: gèng hǎo de shí xiàn
一个劲地问: yí gè jìn de wèn
冷冷地看着: lěng lěng de kàn zhe
猛地想起来: měng de xiǎng qǐ lái
猛地站起来: měng de zhàn qǐ lái
只要认真地: zhǐ yào rèn zhēn de
较好地落实: jiào hǎo de luò shí
不是很好地: bú shì hěn hǎo de
频繁地更换: pín fán de gēng huàn
能够更快地: néng gòu gèng kuài de
能够正确地: néng gòu zhèng què de
痴痴地看着: chī chī de kàn zhe
高兴地大笑: gāo xìng de dà xiào
深情地看着: shēn qíng de kàn zhe
恶狠狠地说: è hěn hěn de shuō
不能简单地: bù néng jiǎn dān de
深深地扎进: shēn shēn de zhā jìn
一个个地来: yí gè gè de lái
广泛深入地: guǎng fàn shēn rù de
圆满地完成: yuán mǎn de wán chéng
怔怔地看着: zhēng zhēng de kàn zhe
只是定定地: zhǐ shì deng deng de
呆呆地站着: dāi dāi de zhàn zhe
更要好好地: gèng yāo hǎo hǎo de
静静地坐着: jìng jìng de zuò zhe
无限地夸大: wú xiàn de kuā dà
渐渐地远去: jiàn jiàn de yuǎn qù
渐渐地消失: jiàn jiàn de xiāo shī
渐渐地失去: jiàn jiàn de shī qù
渐渐地明白: jiàn jiàn de míng bái
健康地活着: jiàn kāng de huó zhe
健康地成长: jiàn kāng de chéng zhǎng
不停地说话: bù tíng de shuō huà
吃惊地发现: chī jīng de fā xiàn
呆呆地看住: dāi dāi de kàn zhù
很好地实现: hěn hǎo de shí xiàn
隐约地听到: yǐn yuē de tīng dào
这样地喜欢: zhè yàng de xǐ huān
更多地是在: gèng duō de shì zài
静静地看着: jìng jìng de kàn zhe
科学地安排: kē xué de ān pái
慢慢地发出: màn màn de fā chū
迅速地离开: xùn sù de lí kāi
很兴奋地说: hěn xīng fèn de shuō
自由地选择: zì yóu de xuǎn zé
冷静地分析: lěng jìng de fēn xī
灵活地转动: líng huó de zhuàn dòng
不断地修正: bù duàn de xiū zhèng
不住地颤抖: bú zhù de chàn dǒu
很认真地看: hěn rèn zhēn de kàn
还是好好地: hái shì hǎo hǎo de
更好地应付: gèng hǎo de yìng fù
尽可能快地: jìn kě néng kuài de
极大地干扰: jí dà de gān rǎo
痛苦地死去: tòng kǔ de sǐ qù
仔细地说出: zǐ xì de shuō chū
仔细地回忆: zǐ xì de huí yì
非常地不满: fēi cháng de bù mǎn
总是神秘地: zǒng shì shén mì de
慢慢地有些: màn màn de yǒu xiē
我会尽量地: wǒ huì jǐn liàng de
兴奋地叫道: xīng fèn de jiào dào
只能不断地: zhǐ néng bù duàn de
可以放心地: kě yǐ fàng xīn de
轻轻地捶着: qīng qīng de chuí zhe
轻轻地吹着: qīng qīng de chuī zhe
十分地关注: shí fēn de guān zhù
顺利地到达: shùn lì de dào dá
万分地小心: wàn fēn de xiǎo xīn
要尽可能地: yào jìn kě néng de
有选择性地: yǒu xuǎn zé xìng de
只会简单地: zhǐ huì jiǎn dān de
正确地进行: zhèng què de jìn xíng
没有很好地: méi yǒu hěn hǎo de
兴奋地大叫: xīng fèn de dà jiào
仔细地看着: zǐ xì de kàn zhe
更好地发挥: gèng hǎo de fā huī
积极地改善: jī jí de gǎi shàn
冷冷地说道: lěng lěng de shuō dào
尽可能地将: jìn kě néng de jiāng
并且自觉地: bìng qiě zì jué de
不断地成长: bù duàn de chéng zhǎng
快速地消散: kuài sù de xiāo sàn
渐渐地发现: jiàn jiàn de fā xiàn
可以准确地: kě yǐ zhǔn què de
爽快地答应: shuǎng kuài de dā yìng
舒舒服服地: shū shū fú fú de
痛痛快快地: tòng tòng kuài kuài de
已经慢慢地: yǐ jīng màn màn de
已经清楚地: yǐ jīng qīng chǔ de
都是那么地: dōu shì nà me de
疯狂地增长: fēng kuáng de zēng zhǎng
更好地生存: gèng hǎo de shēng cún
不断地补充: bù duàn de bǔ chōng
很快地跑来: hěn kuài de pǎo lái
非常地好用: fēi cháng de hǎo yòng
安安静静地: ān ān jìng jìng de
都能很好地: dōu néng hěn hǎo de
更好地了解: gèng hǎo de liǎo jiě
明确地知道: míng què de zhī dào
只要简单地: zhǐ yào jiǎn dān de
我会好好地: wǒ huì hǎo hǎo de
依依不舍地: yī yī bù shě de
我会慢慢地: wǒ huì màn màn de
先是细细地: xiān shì xì xì de
心中偷偷地: xīn zhōng tōu tōu de
迅速地提升: xùn sù de tí shēng
心照不宣地: xīn zhào bù xuān de
用力地撞击: yòng lì de zhuàng jī
一味地强调: yī wèi de qiáng diào
用力地踢开: yòng lì de tī kāi
也会慢慢地: yě huì màn màn de
用力地抛起: yòng lì de pāo qǐ
已经深深地: yǐ jīng shēn shēn de
应该好好地: yīng gāi hǎo hǎo de
只能默默地: zhǐ néng mò mò de
重重地打在: zhòng zhòng de dǎ zài
真诚地希望: zhēn chéng de xī wàng
准确地找出: zhǔn què de zhǎo chū
重重地落下: zhòng zhòng de là xià
暂时地失去: zàn shí de shī qù
准确地打在: zhǔn què de dǎ zài
正在疯狂地: zhèng zài fēng kuáng de
人为地干涉: rén wéi de gān shè
不是好好地: bú shì hǎo hǎo de
很有默契地: hěn yǒu mò qì de
放心地走了: fàng xīn de zǒu le
很好地识别: hěn hǎo de shí bié
更好地解决: gèng hǎo de jiě jué
乖乖地交钱: guāi guāi de jiāo qián
更好地改进: gèng hǎo de gǎi jìn
更快更好地: gèng kuài gèng hǎo de
静静地看书: jìng jìng de kàn shū
极大地削弱: jí dà de xuē ruò
就是狠狠地: jiù shì hěn hěn de
绝望地发现: jué wàng de fā xiàn
非常激烈地: fēi cháng jī liè de
更好地控制: gèng hǎo de kòng zhì
紧紧地抓住: jǐn jǐn de zhuā zhù
轻轻地一推: qīng qīng de yī tuī
用力地拉着: yòng lì de lā zhe
仔细地听着: zǐ xì de tīng zhe
可是很快地: kě shì hěn kuài de
苦苦地挣扎: kǔ kǔ de zhēng zhá
可以很快地: kě yǐ hěn kuài de
慢慢地说着: màn màn de shuō zhe
慢慢地改变: màn màn de gǎi biàn
磨磨蹭蹭地: mó mó cèng cèng de
慢慢地消失: màn màn de xiāo shī
慢慢地醒来: màn màn de xǐng lái
慢慢地消散: màn màn de xiāo sàn
平静地过去: píng jìng de guò qù
轻轻地拉着: qīng qīng de lā zhe
随意地坐在: suí yì de zuò zài
他们不停地: tā men bù tíng de
偷偷地收集: tōu tōu de shōu jí
偷偷地离开: tōu tōu de lí kāi
偷偷地笑了: tōu tōu de xiào le
好好地想想: hǎo hǎo de xiǎng xiǎng
很好地满足: hěn hǎo de mǎn zú
更多地放在: gèng duō de fàng zài
渐渐地有些: jiàn jiàn de yǒu xiē
尽快地吸收: jǐn kuài de xī shōu
确切地来说: què qiè de lái shuō
随随便便地: suí suí biàn biàn de
正确地使用: zhèng què de shǐ yòng
好奇地问道: hào qí de wèn dào
乖乖地坐在: guāi guāi de zuò zài
尽情地享受: jìn qíng de xiǎng shòu
慢慢地腐蚀: màn màn de fǔ shí
双手紧紧地: shuāng shǒu jǐn jǐn de
需要不断地: xū yào bù duàn de
只有真正地: zhǐ yǒu zhēn zhèng de
只能无奈地: zhǐ néng wú nài de
天真地认为: tiān zhēn de rèn wéi
挨家挨户地: āi jiā āi hù de
不要盲目地: bú yào máng mù de
不厌其烦地: bù yàn qí fán de
不动声色地: bù dòng shēng sè de
才能真正地: cái néng zhēn zhèng de
非常地感谢: fēi cháng de gǎn xiè
很自由地打: hěn zì yóu de dǎ
还要乖乖地: hái yào guāi guāi de
更好地分享: gèng hǎo de fēn xiǎng
紧紧地靠着: jǐn jǐn de kào zhe
尽情地嘲讽: jìn qíng de cháo fěng
轻轻地放在: qīng qīng de fàng zài
挺奇怪地说: tǐng qí guài de shuō
委屈地望着: wěi qū de wàng zhe
小声地问道: xiǎo shēng de wèn dào
于是乖乖地: yú shì guāi guāi de
相当地不错: xiāng dāng de bù cuò
相当地好用: xiāng dāng de hǎo yòng
隐约地看见: yǐn yuē de kàn jiàn
只能隐约地: zhǐ néng yǐn yuē de
被动地接受: bèi dòng de jiē shòu
很好地输入: hěn hǎo de shū rù
更好地满足: gèng hǎo de mǎn zú
安静地死去: ān jìng de sǐ qù
然后偷偷地: rán hòu tōu tōu de
能很方便地: néng hěn fāng biàn de
能够很好地: néng gòu hěn hǎo de
不能偷偷地: bù néng tōu tōu de
不停地摇着: bù tíng de yáo zhe
不会那样地: bú huì nà yàng de
不能公正地: bù néng gōng zhèng de
不停地发出: bù tíng de fā chū
不约而同地: bù yuē ér tóng de
不断地添加: bù duàn de tiān jiā
迟疑地看着: chí yí de kàn zhe
才能顺利地: cái néng shùn lì de
大量地使用: dà liàng de shǐ yòng
单纯地追求: dān chún de zhuī qiú
都在不停地: dōu zài bù tíng de
放心地饮用: fàng xīn de yǐn yòng
很好地使用: hěn hǎo de shǐ yòng
很流畅地用: hěn liú chàng de yòng
猛地一翻身: měng de yī fān shēn
不断地重复: bù duàn de chóng fù
不过很快地: bù guò hěn kuài de
彻底地放弃: chè dǐ de fàng qì
可以轻轻地: kě yǐ qīng qīng de
能够很快地: néng gòu hěn kuài de
能够正常地: néng gòu zhèng cháng de
不断地挣扎: bù duàn de zhēng zhá
不断地超越: bù duàn de chāo yuè
不断地治疗: bù duàn de zhì liáo
昏昏沉沉地: hūn hūn chén chén de
很好地掌握: hěn hǎo de zhǎng wò
才能成功地: cái néng chéng gōng de
这么自由地: zhè me zì yóu de
快捷地设置: kuài jié de shè zhì
冒失地进去: mào shī de jìn qù
流畅地输入: liú chàng de shū rù
不停地告饶: bù tíng de gào ráo
不停地发抖: bù tíng de fā dǒu
才能平安地: cái néng píng ān de
匆匆忙忙地: cōng cōng máng máng de
大方地拿出: dà fāng de ná chū
好好地整顿: hǎo hǎo de zhěng dùn
还是乖乖地: hái shì guāi guāi de
紧紧地握住: jǐn jǐn de wò zhù
及时地推出: jí shí de tuī chū
默默地看着: mò mò de kàn zhe
慢慢地走到: màn màn de zǒu dào
轻轻地咬着: qīng qīng de yǎo zhe
清楚地写在: qīng chǔ de xiě zài
亲热地搂着: qīn rè de lǒu zhe
特别地敏感: tè bié de mǐn gǎn
微微地笑着: wēi wēi de xiào zhe
迅速地蔓延: xùn sù de màn yán
需要好好地: xū yào hǎo hǎo de
有效地控制: yǒu xiào de kòng zhì
用力地一拧: yòng lì de yī níng
一边好奇地: yī biān hào qí de
有些遗憾地: yǒu xiē yí hàn de
这才真正地: zhè cái zhēn zhèng de
才能顺畅地: cái néng shùn chàng de
才能迅速地: cái néng xùn sù de
定定地望向: deng deng de wàng xiàng
只能乖乖地: zhǐ néng guāi guāi de
只有不断地: zhǐ yǒu bù duàn de
连贯地输入: lián guàn de shū rù
能否简单地: néng fǒu jiǎn dān de
不断地影响: bù duàn de yǐng xiǎng
不停地求饶: bù tíng de qiú ráo
好好地活着: hǎo hǎo de huó zhe
好好地对待: hǎo hǎo de duì dài
非常地有利: fēi cháng de yǒu lì
狠狠地教训: hěn hěn de jiào xùn
就会更好地: jiù huì gèng hǎo de
看他不停地: kàn tā bù tíng de
苦苦地哀求: kǔ kǔ de āi qiú
慢慢地恢复: màn màn de huī fù
拼命地抵抗: pīn mìng de dǐ kàng
轻轻地说着: qīng qīng de shuō zhe
无奈地笑道: wú nài de xiào dào
相当地有效: xiāng dāng de yǒu xiào
用力地一捏: yòng lì de yī niē
如何有效地: rú hé yǒu xiào de
笑呵呵地说: xiào hē hē de shuō
也能安全地: yě néng ān quán de
总是不时地: zǒng shì bù shí de
静静地坐在: jìng jìng de zuò zài
静静地听着: jìng jìng de tīng zhe
紧紧地贴在: jǐn jǐn de tiē zài
紧紧地搂住: jǐn jǐn de lǒu zhù
静静地等待: jìng jìng de děng dài
积极地收集: jī jí de shōu jí
将会极大地: jiāng huì jí dà de
可以平静地: kě yǐ píng jìng de
可以流利地: kě yǐ liú lì de
快速地切换: kuài sù de qiè huàn
猛地一拍手: měng de yī pāi shǒu
满意地笑了: mǎn yì de xiào le
慢慢地发现: màn màn de fā xiàn
频繁地更新: pín fán de gēng xīn
亲密地挽着: qīn mì de wǎn zhe
我们坚定地: wǒ men jiān deng de
我也好好地: wǒ yě hǎo hǎo de
羞涩地问道: xiū sè de wèn dào
疑惑地看着: yí huò de kàn zhe
也在不停地: yě zài bù tíng de
有说有笑地: yǒu shuō yǒu xiào de
也会不时地: yě huì bù shí de
只要不断地: zhǐ yào bù duàn de
缓缓地走上: huǎn huǎn de zǒu shàng
很好地转换: hěn hǎo de zhuǎn huàn
狠狠地插进: hěn hěn de chā jìn
非常地困难: fēi cháng de kùn nán
还是稳稳地: hái shì wěn wěn de
还时不时地: hái shí bù shí de
毫无保留地: háo wú bǎo liú de
会不自觉地: huì bù zì jué de
很好地享受: hěn hǎo de xiǎng shòu
更好地配合: gèng hǎo de pèi hé
更好地维护: gèng hǎo de wéi hù
更多地留给: gèng duō de liú gěi
静静地走着: jìng jìng de zǒu zhe
就象征性地: jiù xiàng zhēng xìng de
较好地控制: jiào hǎo de kòng zhì
淡淡地解释: dàn dàn de jiě shì
坏坏地看着: huài huài de kàn zhe
更准确地说: gèng zhǔn què de shuō
轻轻地抱住: qīng qīng de bào zhù
适当地提高: shì dàng de tí gāo
完全地破开: wán quán de pò kāi
只是静静地: zhǐ shì jìng jìng de
出色地完成: chū sè de wán chéng
从而成功地: cóng ér chéng gōng de
持续不断地: chí xù bú duàn de
更多地关心: gèng duō de guān xīn
激动地哭了: jī dòng de kū le
紧紧地绑在: jǐn jǐn de bǎng zài
可以迅速地: kě yǐ xùn sù de
随意地发出: suí yì de fā chū
不住地呕吐: bú zhù de ǒu tù
从而更好地: cóng ér gèng hǎo de
艰难地开口: jiān nán de kāi kǒu
目不转睛地: mù bù zhuǎn jīng de
深深地鞠躬: shēn shēn de jū gōng
我很认真地: wǒ hěn rèn zhēn de
相对正确地: xiāng duì zhèng què de
迅速地抓住: xùn sù de zhuā zhù
相当地同意: xiāng dāng de tóng yì
很快地消失: hěn kuài de xiāo shī
逐渐地失去: zhú jiàn de shī qù
郁闷地坐在: yù mèn de zuò zài
郁闷地坐着: yù mèn de zuò zhe
战战兢兢地: zhàn zhàn jīng jīng de
郑重地希望: zhèng zhòng de xī wàng
你要好好地: nǐ yāo hǎo hǎo de
不幸地成为: bù xìng de chéng wéi
呆呆地坐在: dāi dāi de zuò zài
非常地愿意: fēi cháng de yuàn yì
非常地清楚: fēi cháng de qīng chǔ
和平地解决: hé píng de jiě jué
不断地向着: bù duàn de xiàng zhe
狠狠地砸在: hěn hěn de zá zài
可以随意地: kě yǐ suí yì de
慢慢地研究: màn màn de yán jiū
只想好好地: zhǐ xiǎng hǎo hǎo de
这才缓缓地: zhè cái huǎn huǎn de
慢慢地适应: màn màn de shì yìng
轻轻地捏着: qīng qīng de niē zhe
生气地看着: shēng qì de kàn zhe
深深地陷在: shēn shēn de xiàn zài
深深地刺进: shēn shēn de cì jìn
有效地改进: yǒu xiào de gǎi jìn
只是呆呆地: zhǐ shì dāi dāi de
正确地对待: zhèng què de duì dài
着急地想要: zháo jí de xiǎng yào
正笑吟吟地: zhèng xiào yín yín de
仔细地看过: zǐ xì de kàn guò
仔细地研究: zǐ xì de yán jiū
正在痴痴地: zhèng zài chī chī de
这么方便地: zhè me fāng biàn de
深深地感到: shēn shēn de gǎn dào
我呆呆地看: wǒ dāi dāi de kàn
自由地调整: zì yóu de tiáo zhěng
认真地进行: rèn zhēn de jìn xíng
如果慢慢地: rú guǒ màn màn de
热情地提出: rè qíng de tí chū
能够更好地: néng gòu gèng hǎo de
不情愿地说: bù qíng yuàn de shuō
大声地喊道: dà shēng de hǎn dào
有效地提高: yǒu xiào de tí gāo
高兴地接过: gāo xìng de jiē guò
紧张地盯着: jǐn zhāng de dīng zhe
紧张地握着: jǐn zhāng de wò zhe
没有真正地: méi yǒu zhēn zhèng de
明显地放大: míng xiǎn de fàng dà
需要大量地: xū yào dà liàng de
轻轻地推开: qīng qīng de tuī kāi
顺利地完成: shùn lì de wán chéng
贪婪地看着: tān lán de kàn zhe
委屈地看着: wěi qū de kàn zhe
也尽可能地: yě jìn kě néng de
自由地成长: zì yóu de chéng zhǎng
则是不断地: zé shì bù duàn de
能够不断地: néng gòu bù duàn de
令人气恼地: lìng rén qì nǎo de
不住地咳嗽: bú zhù de ké sòu
很委屈地说: hěn wěi qū de shuō
无奈地摇头: wú nài de yáo tóu
正确地输入: zhèng què de shū rù
很高兴地说: hěn gāo xìng de shuō
牢牢地记住: láo láo de jì zhù
大胆地尝试: dà dǎn de cháng shì
很好地转变: hěn hǎo de zhuǎn biàn
很负责地说: hěn fù zé de shuō
可以任意地: kě yǐ rèn yì de
莫名其妙地: mò míng qí miào de
使劲地摇头: shǐ jìn de yáo tóu
再客观地说: zài kè guān de shuō
不断地摇头: bù duàn de yáo tóu
成功地推广: chéng gōng de tuī guǎng
如何很好地: rú hé hěn hǎo de
安静地坐着: ān jìng de zuò zhe
不是简单地: bú shì jiǎn dān de
不能正确地: bù néng zhèng què de
很好地修改: hěn hǎo de xiū gǎi
还是顺利地: hái shì shùn lì de
很好地控制: hěn hǎo de kòng zhì
高兴地离开: gāo xìng de lí kāi
较好地了解: jiào hǎo de liǎo jiě
及时地进行: jí shí de jìn xíng
可以快速地: kě yǐ kuài sù de
满意地离开: mǎn yì de lí kāi
都要不停地: dōu yào bù tíng de
从而大大地: cóng ér dà dà de
不停地旋转: bù tíng de xuán zhuǎn
方便地查看: fāng biàn de chá kàn
非常地开心: fēi cháng de kāi xīn
更快地适应: gèng kuài de shì yìng
静静地想着: jìng jìng de xiǎng zhe
惊讶地看着: jīng yà de kàn zhe
默默地离去: mò mò de lí qù
为了有效地: wèi le yǒu xiào de
正常地进行: zhèng cháng de jìn xíng
很好地达到: hěn hǎo de dá dào
方便地使用: fāng biàn de shǐ yòng
毫不犹豫地: háo bù yóu yù de
更好地体验: gèng hǎo de tǐ yàn
牢牢地抓住: láo láo de zhuā zhù
耐心地等待: nài xīn de děng dài
人为地加入: rén wéi de jiā rù
惊讶地发现: jīng yà de fā xiàn
已经尽量地: yǐ jīng jǐn liàng de
仔细地看看: zǐ xì de kàn kàn
一直安静地: yì zhí ān jìng de
勇敢地迎接: yǒng gǎn de yíng jiē
正确地显示: zhèng què de xiǎn shì
更多地关注: gèng duō de guān zhù
大大地提高: dà dà de tí gāo
开玩笑地说: kāi wán xiào de shuō
悄悄地走人: qiāo qiāo de zǒu rén
已经成功地: yǐ jīng chéng gōng de
高兴地大叫: gāo xìng de dà jiào
不客气地说: bú kè qì de shuō
不停地提升: bù tíng de tí shēng
敏感地发现: mǐn gǎn de fā xiàn
冷冷地回答: lěng lěng de huí dá
能够有效地: néng gòu yǒu xiào de
竟哇地一声: jìng wa de yī shēng
我再简单地: wǒ zài jiǎn dān de
不住地磕头: bú zhù de kē tóu
仍然不断地: réng rán bù duàn de
能够较好地: néng gòu jiào hǎo de
慢慢地走着: màn màn de zǒu zhe
悄悄地站在: qiāo qiāo de zhàn zài
清楚地知道: qīng chǔ de zhī dào
无可奈何地: wú kě nài hé de
才能最好地: cái néng zuì hǎo de
恨恨地离开: hèn hèn de lí kāi
积极地推动: jī jí de tuī dòng
极大地改善: jí dà de gǎi shàn
无力地看着: wú lì de kàn zhe
不遗余力地: bù yí yú lì de
不停地闪烁: bù tíng de shǎn shuò
尽可能多地: jìn kě néng duō de
极力地掩饰: jí lì de yǎn shì
好好地聊聊: hǎo hǎo de liáo liáo
高兴地走了: gāo xìng de zǒu le
永远地消失: yǒng yuǎn de xiāo shī
真正地满足: zhēn zhèng de mǎn zú
坚定不移地: jiān deng bù yí de
坚持不懈地: jiān chí bù xiè de
实事求是地: shí shì qiú shì de
不同程度地: bù tóng chéng dù de
不由自主地: bù yóu zì zhǔ de
深有感触地: shēn yǒu gǎn chù de
情不自禁地: qíng bù zì jīn de
一步一步地: yí bù yí bù de
不好意思地: bù hǎo yì sī de
滔滔不绝地: tāo tāo bù jué de
要有计划地: yào yǒu jì huà de
高兴地说道: gāo xìng de shuō dào
郑重其事地: zhèng zhòng qí shì de
当之无愧地: dāng zhī wú kuì de
愤愤不平地: fèn fèn bù píng de
好好地招待: hǎo hǎo de zhāo dài
假惺惺地说: jiǎ xīng xīng de shuō
静静地呆着: jìng jìng de dāi zhe
极大地提升: jí dà de tí shēng
慢慢地来吧: màn màn de lái ba
清晰地看到: qīng xī de kàn dào
源源不断地: yuán yuán bù duàn de
最大限度地: zuì dà xiàn dù de
真正地快乐: zhēn zhèng de kuài lè
真真正正地: zhēn zhēn zhèng zhèng de
自以为是地: zì yǐ wéi shì de
昼夜不断地: zhòu yè bù duàn de
自由地翱翔: zì yóu de áo xiáng
装模作样地: zhuāng mú zuò yàng de
正确地分析: zhèng què de fēn xī
专心致志地: zhuān xīn zhì zhì de
仔细地打量: zǐ xì de dǎ liàng
直言不讳地: zhí yán bù huì de
字迹清楚地: zì jì qīng chǔ de
直接了当地: zhí jiē liǎo dàng de
最好地发展: zuì hǎo de fā zhǎn
异口同声地: yì kǒu tóng shēng de
一个一个地: yí gè yí gè de
勇敢地对付: yǒng gǎn de duì fù
一点一点地: yì diǎn yì diǎn de
有代表性地: yǒu dài biǎo xìng de
越来越多地: yuè lái yuè duō de
有力地证明: yǒu lì de zhèng míng
有力地推动: yǒu lì de tuī dòng
郁闭地沉思: yù bì de chén sī
一次一次地: yī cì yī cì de
心情地流淌: xīn qíng de liú tǎng
稀奇古怪地: xī qí gǔ guài de
辛勤地工作: xīn qín de gōng zuò
系统地阐述: xì tǒng de chǎn shù
笑嘻嘻地说: xiào xī xī de shuō
小心翼翼地: xiǎo xīn yì yì de
斜向一边地: xié xiàng yī biān de
详细地说明: xiáng xì de shuō míng
详细地检查: xiáng xì de jiǎn chá
幸运地拥有: xìng yùn de yōng yǒu
小河般地流: xiǎo hé bān de liú
徐缓地移动: xú huǎn de yí dòng
显而易见地: xiǎn ér yì jiàn de
心不在焉地: xīn bù zài yān de
顽固地坚持: wán gù de jiān chí
无可非议地: wú kě fēi yì de
完满地结束: wán mǎn de jié shù
完满地解决: wán mǎn de jiě jué
委屈地哭了: wěi qū de kū le
顽强地奋斗: wán qiáng de fèn dòu
顽强地拚搏: wán qiáng de pàn bó
无所事事地: wú suǒ shì shì de
无说服力地: wú shuō fú lì de
武断地提出: wǔ duàn de tí chū
委任统治地: wěi rèn tǒng zhì de
无力地靠在: wú lì de kào zài
无能为力地: wú néng wéi lì de
同时发生地: tóng shí fā shēng de
特殊气候地: tè shū qì hòu de
吞吞地前进: tūn tūn de qián jìn
突飞猛进地: tū fēi měng jìn de
痛苦地呻吟: tòng kǔ de shēn yín
神情激动地: shén qíng jī dòng de
深情地呼唤: shēn qíng de hū huàn
深切地怀念: shēn qiè de huái niàn
舒适地坐定: shū shì de zuò deng
深信不疑地: shēn xìn bù yí de
使劲地鼓掌: shǐ jìn de gǔ zhǎng
深刻地指出: shēn kè de zhǐ chū
深刻地解剖: shēn kè de jiě pōu
世代相传地: shì dài xiāng chuán de
生动活泼地: shēng dòng huó pō de
少量地分配: shǎo liàng de fēn pèi
熟练地进入: shú liàn de jìn rù
熟练地使用: shú liàn de shǐ yòng
却不好好地: què bù hǎo hǎo de
清楚地看到: qīng chǔ de kàn dào
气喘吁吁地: qì chuǎn xū xū de
确定无疑地: què deng wú yí de
前后来回地: qián hòu lái huí de
前后直排地: qián hòu zhí pái de
轻蔑地一笑: qīng miè de yī xiào
轻蔑地拒绝: qīng miè de jù jué
全面地认识: quán miàn de rèn shí
亲密地合作: qīn mì de hé zuò
悄悄地开门: qiāo qiāo de kāi mén
亲切地交谈: qīn qiè de jiāo tán
全神贯注地: quán shén guàn zhù de
全心全意地: quán xīn quán yì de
嘁喳喳地叫: qī zhā zhā de jiào
没好气地说: méi hǎo qì de shuō
冒冒失失地: mào mào shī shī de
慢慢地煮沸: màn màn de zhǔ fèi
默默地承受: mò mò de chéng shòu
勉强地笑道: miǎn qiǎng de xiào dào
明确地叙述: míng què de xù shù
密切地联系: mì qiè de lián xì
没完没了地: méi wán méi liǎo de
没有神采地: méi yǒu shén cǎi de
科学地概括: kē xué de gài kuò
可以接受地: kě yǐ jiē shòu de
忙碌地来回: máng lù de lái huí
朦胧地出现: méng lóng de chū xiàn
漫不经心地: màn bù jīng xīn de
快快乐乐地: kuài kuài lè lè de
居心叵测地: jū xīn pǒ cè de
经验主义地: jīng yàn zhǔ yì de
紧张不安地: jǐn zhāng bù ān de
紧张地工作: jǐn zhāng de gōng zuò
紧密地合作: jǐn mì de hé zuò
静脉注射地: jìng mài zhù shè de
紧密地结合: jǐn mì de jié hé
惊奇地发现: jīng qí de fā xiàn
精确地找到: jīng què de zhǎo dào
坚实可靠地: jiān shí kě kào de
急速地跳动: jí sù de tiào dòng
艰苦地劳动: jiān kǔ de láo dòng
几乎正确地: jī hū zhèng què de
紧紧地抱住: jǐn jǐn de bào zhù
局促不安地: jú cù bù ān de
惊人显着地: jīng rén xiǎn zhe de
精力旺盛地: jīng lì wàng shèng de
惊人地相似: jīng rén de xiāng sì
过早地死去: guò zǎo de sǐ qù
孤注一掷地: gū zhù yí zhì de
高声地说话: gāo shēng de shuō huà
光明正大地: guāng míng zhèng dà de
更确切地说: gèng què qiè de shuō
乖乖地回去: guāi guāi de huí qù
高高兴兴地: gāo gāo xìng xīng de
更精确地说: gèng jīng què de shuō
更好地活着: gèng hǎo de huó zhe
更好地发展: gèng hǎo de fā zhǎn
光辉灿烂地: guāng huī càn làn de
更好地代表: gèng hǎo de dài biǎo
更好地促进: gèng hǎo de cù jìn
更好地推动: gèng hǎo de tuī dòng
过多地供应: guò duō de gōng yìng
光彩夺目地: guāng cǎi duó mù de
故弄玄虚地: gù nòng xuán xū de
概略地叙述: gài lüè de xù shù
欢天喜地地: huān tiān xǐ de de
毫无痛苦地: háo wú tòng kǔ de
毫无疑问地: háo wú yí wèn de
反响强烈地: fǎn xiǎng qiáng liè de
会心地一笑: huì xīn de yī xiào
会心地笑了: huì xīn de xiào le
缓慢地行进: huǎn màn de xíng jìn
合情合理地: hé qíng hé lǐ de
狠狠地骂道: hěn hěn de mà dào
很好地生活: hěn hǎo de shēng huó
含糊地发音: hán hú de fā yīn
厚厚地涂抹: hòu hòu de tú mǒ
飞快地跑开: fēi kuài de pǎo kāi
很快地出现: hěn kuài de chū xiàn
飞快地奔驰: fēi kuài de bēn chí
非常非常地: fēi cháng fēi cháng de
非常热情地: fēi cháng rè qíng de
非常迅速地: fēi cháng xùn sù de
非常严重地: fēi cháng yán zhòng de
毫不容情地: háo bù róng qíng de
断续地干咳: duàn xù de gān hāi
大声地要求: dà shēng de yāo qiú
狼吞虎咽地吃: láng tūn hǔ yàn de chī
懒洋洋地倚靠: lǎn yáng yáng de yǐ kào
不得随地吐痰: bù dé suí de tǔ tán
不断地做某事: bù duàn de zuò mǒu shì
不友好地对待: bù yǒu hǎo de duì dài
不怨天不怨地: bù yuàn tiān bù yuàn de
被永久地接受: bèi yǒng jiǔ de jiē shòu
不真诚地恋爱: bù zhēn chéng de liàn ài
彻底地想一想: chè dǐ de xiǎng yī xiǎng
成功地做某事: chéng gōng de zuò mǒu shì
成群结队地走: chéng qún jié duì de zǒu
东倒西歪地走: dōng dǎo xī wāi de zǒu
大幅度地超过: dà fú dù de chāo guò
也是我本能地: yě shì wǒ běn néng de
有条件地投降: yǒu tiáo jiàn de tóu xiáng
一厢情愿地想: yì xiāng qíng yuàn de xiǎng
一夜又一夜地: yī yè yòu yī yè de
以压倒之势地: yǐ yā dǎo zhī shì de
源源不断地流: yuán yuán bù duàn de liú
仔细地想一想: zǐ xì de xiǎng yī xiǎng
不断地去尝试: bù duàn de qù cháng shì
不断地去淬炼: bù duàn de qù cuì liàn
不断地去淬取: bù duàn de qù cuì qǔ
不会又悄悄地: bú huì yòu qiāo qiāo de
不停地换花样: bù tíng de huàn huā yàng
不自觉地出现: bù zì jué de chū xiàn
都是直直地下: dōu shì zhí zhí de xià
狠狠地扁一顿: hěn hěn de biǎn yī dùn
极力地克制着: jí lì de kè zhì zhe
静静地看着你: jìng jìng de kàn zhe nǐ
靠自己不断地: kào zì jǐ bù duàn de
慢慢地渗透到: màn màn de shèn tòu dào
悄悄地瞥几眼: qiāo qiāo de piē jǐ yǎn
清晰地昭示着: qīng xī de zhāo shì zhe
深深地埋藏在: shēn shēn de mái cáng zài
挖空心思地去: wā kōng xīn sī de qù
我一直不停地: wǒ yì zhí bù tíng de
一朵一朵地采: yī duǒ yī duǒ de cǎi
一朵一朵地摘: yī duǒ yī duǒ de zhāi
用眼睛偷偷地: yòng yǎn jīng tōu tōu de
雨是斜斜地下: yǔ shì xié xié de xià
心满意足地看: xīn mǎn yì zú de kàn
仔细地看一下: zǐ xì de kàn yī xià
不正当地使用: bù zhèng dāng de shǐ yòng
不停地叫喊着: bù tíng de jiào hǎn zhe
为了能方便地: wèi le néng fāng biàn de
尽可能地消除: jìn kě néng de xiāo chú
能清楚地看到: néng qīng chǔ de kàn dào
隐隐地感觉到: yǐn yǐn de gǎn jué dào
尽可能地优化: jìn kě néng de yōu huà
没日没夜地干: méi rì méi yè de gàn
尽可能地照顾: jìn kě néng de zhào gù
很清楚地知道: hěn qīng chǔ de zhī dào
还不能很好地: hái bù néng hěn hǎo de
可以明确地说: kě yǐ míng què de shuō
成功地为自己: chéng gōng de wèi zì jǐ
也一步一步地: yě yí bù yí bù de
一点点地做好: yì diǎn diǎn de zuò hǎo
我不再积极地: wǒ bù zài jī jí de
眼睁睁地看着: yǎn zhēng zhēng de kàn zhe
尽可能地减少: jìn kě néng de jiǎn shǎo
渐渐地习惯了: jiàn jiàn de xí guàn le
慢慢地就学会: màn màn de jiù xué huì
实事求是地讲: shí shì qiú shì de jiǎng
能很好地完成: néng hěn hǎo de wán chéng
毫不客气地说: háo bú kè qì de shuō
能很好地解决: néng hěn hǎo de jiě jué
弱弱地问一句: ruò ruò de wèn yī jù
不定期地检查: bù deng qī de jiǎn chá
并更好地实现: bìng gèng hǎo de shí xiàn
狠狠地打击了: hěn hěn de dǎ jī le
都没有很好地: dōu méi yǒu hěn hǎo de
很清楚地听到: hěn qīng chǔ de tīng dào
将会尽可能地: jiāng huì jìn kě néng de
明白地告诉你: míng bái de gào sù nǐ
清楚地感觉到: qīng chǔ de gǎn jué dào
针对性地解决: zhēn duì xìng de jiě jué
小心翼翼地问: xiǎo xīn yì yì de wèn
也可以很好地: yě kě yǐ hěn hǎo de
能不能偷偷地: néng bù néng tōu tōu de
有选择地添加: yǒu xuǎn zé de tiān jiā
客观地反映出: kè guān de fǎn yìng chū
泛泛地看一遍: fàn fàn de kàn yī biàn
可以肯定地说: kě yǐ kěn deng de shuō
我需要好好地: wǒ xū yào hǎo hǎo de
我非常地抱歉: wǒ fēi cháng de bào qiàn
我们将逐步地: wǒ men jiāng zhú bù de
悠闲地抽着烟: yōu xián de chōu zhe yān
一个劲地抱怨: yí gè jìn de bào yuàn
一次又一次地: yī cì yòu yī cì de
严重地伤害了: yán zhòng de shāng hài le
只能眼睁睁地: zhǐ néng yǎn zhēng zhēng de
白白地浪费了: bái bái de làng fèi le
更多地是为了: gèng duō de shì wèi le
极大地提高了: jí dà de tí gāo le
更轻松地访问: gèng qīng sōng de fǎng wèn
尽可能地搜集: jìn kě néng de sōu jí
可以很方便地: kě yǐ hěn fāng biàn de
猛地抬起了头: měng de tái qǐ le tóu
永远地失去了: yǒng yuǎn de shī qù le
可以很负责地: kě yǐ hěn fù zé de
苦苦地等待着: kǔ kǔ de děng dài zhe
可以很清楚地: kě yǐ hěn qīng chǔ de
慢慢地出现在: màn màn de chū xiàn zài
猛地站了起来: měng de zhàn le qǐ lái
慢慢地恢复了: màn màn de huī fù le
慢慢地变成了: màn màn de biàn chéng le
清楚地认识到: qīng chǔ de rèn shí dào
因为我不停地: yīn wèi wǒ bù tíng de
正确地打出来: zhèng què de dǎ chū lái
紧紧地跟随着: jǐn jǐn de gēn suí zhe
极大地丰富了: jí dà de fēng fù le
永远地在一起: yǒng yuǎn de zài yì qǐ
冷冷地回答道: lěng lěng de huí dá dào
等地部分地区: děng de bù fèn de qū
你还是这样地: nǐ hái shì zhè yàng de
并不是简单地: bìng bú shì jiǎn dān de
彻底地征服了: chè dǐ de zhēng fú le
成功地解决了: chéng gōng de jiě jué le
灰溜溜地跑了: huī liū liū de pǎo le
毫不夸张地说: háo bù kuā zhāng de shuō
好奇地问一句: hào qí de wèn yī jù
能不能简单地: néng bù néng jiǎn dān de
你最好乖乖地: nǐ zuì hǎo guāi guāi de
不定期地出现: bù deng qī de chū xiàn
强烈地感觉到: qiáng liè de gǎn jué dào
就可以很好地: jiù kě yǐ hěn hǎo de
很好地说明了: hěn hǎo de shuō míng le
好好地谈一谈: hǎo hǎo de tán yī tán
好好地睡一觉: hǎo hǎo de shuì yī jiào
静静地在一旁: jìng jìng de zài yī páng
慢慢地讲述着: màn màn de jiǎng shù zhe
慢慢地认识了: màn màn de rèn shí le
轻轻地在上面: qīng qīng de zài shàng miàn
自觉地配合着: zì jué de pèi hé zhe
在不断地影响: zài bù duàn de yǐng xiǎng
努力地活下去: nǔ lì de huó xià qù
能更好地实现: néng gèng hǎo de shí xiàn
但是却不时地: dàn shì què bù shí de
面对面地坐在: miàn duì miàn de zuò zài
所以才不停地: suǒ yǐ cái bù tíng de
仔细地观察着: zǐ xì de guān chá zhe
坚定不移地走: jiān deng bù yí de zǒu
语重心长地说: yǔ zhòng xīn cháng de shuō
一直在苦苦地: yì zhí zài kǔ kǔ de
这个要狠狠地: zhè gè yào hěn hěn de
大大地拖累了: dà dà de tuō lěi le
建议有选择地: jiàn yì yǒu xuǎn zé de
还是能很好地: hái shì néng hěn hǎo de
非常地不喜欢: fēi cháng de bù xǐ huān
静静地等待着: jìng jìng de děng dài zhe
静静地思索着: jìng jìng de sī suǒ zhe
有条件地参与: yǒu tiáo jiàn de cān yù
不要有意识地: bú yào yǒu yì shí de
没好气地回答: méi hǎo qì de huí dá
能更好地发挥: néng gèng hǎo de fā huī
懒洋洋地坐在: lǎn yáng yáng de zuò zài
乖乖地走开了: guāi guāi de zǒu kāi le
我迷迷糊糊地: wǒ mí mí hū hū de
也没有很好地: yě méi yǒu hěn hǎo de
会不知不觉地: huì bù zhī bù jué de
恶狠狠地看着: è hěn hěn de kàn zhe
艰难地转过头: jiān nán de zhuǎn guò tóu
开心地离开了: kāi xīn de lí kāi le
深深地感染了: shēn shēn de gǎn rǎn le
我现在慢慢地: wǒ xiàn zài màn màn de
可以有选择地: kě yǐ yǒu xuǎn zé de
杂乱地堆放着: zá luàn de duī fàng zhe
仔细地研究过: zǐ xì de yán jiū guò
只能眼巴巴地: zhǐ néng yǎn bā bā de
想当然地认为: xiǎng dāng rán de rèn wéi
不要想当然地: bú yào xiǎng dāng rán de
不是能更好地: bú shì néng gèng hǎo de
悄悄地调整了: qiāo qiāo de tiáo zhěng le
不会眼睁睁地: bú huì yǎn zhēng zhēng de
很好地解释了: hěn hǎo de jiě shì le
早早地解决了: zǎo zǎo de jiě jué le
如果能不断地: rú guǒ néng bù duàn de
更彻底地分开: gèng chè dǐ de fēn kāi
悄悄地问一句: qiāo qiāo de wèn yī jù
认真地活下去: rèn zhēn de huó xià qù
还没有很好地: hái méi yǒu hěn hǎo de
更好地体现了: gèng hǎo de tǐ xiàn le
静静地体会着: jìng jìng de tǐ huì zhe
明显地感觉到: míng xiǎn de gǎn jué dào
我静静地站着: wǒ jìng jìng de zhàn zhe
我静静地看着: wǒ jìng jìng de kàn zhe
我静静地坐着: wǒ jìng jìng de zuò zhe
会越来越多地: huì yuè lái yuè duō de
给我狠狠地杀: gěi wǒ hěn hěn de shā
狠狠地踩几下: hěn hěn de cǎi jǐ xià
希望能更好地: xī wàng néng gèng hǎo de
笑眯眯地看着: xiào mī mī de kàn zhe
有效地减轻了: yǒu xiào de jiǎn qīng le
一个劲地咳嗽: yí gè jìn de ké sòu
半开玩笑地说: bàn kāi wán xiào de shuō
清醒地认识到: qīng xǐng de rèn shí dào
成功地进行了: chéng gōng de jìn xíng le
很好地解决了: hěn hǎo de jiě jué le
给我狠狠地打: gěi wǒ hěn hěn de dǎ
愤愤不平地说: fèn fèn bù píng de shuō
早早地溜掉了: zǎo zǎo de liū diào le
自言自语地说: zì yán zì yǔ de shuō
最雄辩地证明: zuì xióng biàn de zhèng míng
异口同声地说: yì kǒu tóng shēng de shuō
油麻地避风塘: yóu má de bì fēng táng
圆满地完成了: yuán mǎn de wán chéng le
摇晃地悬挂着: yáo huàng de xuán guà zhe
一个接一个地: yí gè jiē yí gè de
一个劲地鼓掌: yí gè jìn de gǔ zhǎng
下意识地收手: xià yì shí de shōu shǒu
偷偷地到处瞧: tōu tōu de dào chù qiáo
偷偷摸摸地走: tōu tōu mō mō de zǒu
顺时间方向地: shùn shí jiān fāng xiàng de
深深地感受到: shēn shēn de gǎn shòu dào
劈劈啪啪地响: pī pī pā pā de xiǎng
强烈地吸引住: qiáng liè de xī yǐn zhù
亲热地打招呼: qīn rè de dǎ zhāo hū
清楚地意识到: qīng chǔ de yì shí dào
全面地看问题: quán miàn de kàn wèn tí
嘁嘁喳喳地叫: qī qī zhā zhā de jiào
全神贯注地听: quán shén guàn zhù de tīng
没精打采地走: méi jīng dǎ cǎi de zǒu
冒昧地擅自做: mào mèi de shàn zì zuò
慢声慢气地说: màn shēng màn qì de shuō
慢吞吞地前进: màn tūn tūn de qián jìn
科学地总结了: kē xué de zǒng jié le
坚弥地城海旁: jiān mí de chéng hǎi páng
居世界领先地: jū shì jiè lǐng xiān de
艰苦地从事于: jiān kǔ de cóng shì yú
结结巴巴地说: jiē jiē bā bā de shuō
久久地凝视着: jiǔ jiǔ de níng shì zhe
极大地调动了: jí dà de diào dòng le
嘎吱嘎吱地响: gā zhī gā zhī de xiǎng
更紧密地合作: gèng jǐn mì de hé zuò
嘎嚓嘎嚓地响: gā cā gā cā de xiǎng
胡言乱语地说: hú yán luàn yǔ de shuō
大摇大摆地走: dà yáo dà bǎi de zǒu
蹑手蹑脚地走动: niè shǒu niè jiǎo de zǒu dòng
不得随地大小便: bù dé suí de dà xiǎo biàn
不停地提醒自己: bù tíng de tí xǐng zì jǐ
持续稳定地增长: chí xù wěn deng de zēng zhǎng
夜以继日地工作: yè yǐ jì rì de gōng zuò
一字不错地熟记: yī zì bù cuò de shú jì
慢慢地陪着你走: màn màn de péi zhe nǐ zǒu
一视同仁地对待: yī shì tóng rén de duì dài
不断地淬励自己: bù duàn de cuì lì zì jǐ
不断地淬炼话术: bù duàn de cuì liàn huà shù
不断地淬取智慧: bù duàn de cuì qǔ zhì huì
不断地反省自己: bù duàn de fǎn xǐng zì jǐ
不断地做出决定: bù duàn de zuò chū jué deng
才能不断地成长: cái néng bù duàn de chéng zhǎng
长长地舒了口气: cháng cháng de shū le kǒu qì
好想静静地看看: hǎo xiǎng jìng jìng de kàn kàn
会永远地跟随着: huì yǒng yuǎn de gēn suí zhe
极力地克制自己: jí lì de kè zhì zì jǐ
急赶急地赶来了: jí gǎn jí de gǎn lái le
将会大大地减少: jiāng huì dà dà de jiǎn shǎo
紧紧地搂在怀里: jǐn jǐn de lǒu zài huái lǐ
紧紧地粘在一起: jǐn jǐn de zhān zài yì qǐ
强迫自己不断地: qiǎng pò zì jǐ bù duàn de
我也会不停地写: wǒ yě huì bù tíng de xiě
兴奋地蹦了起来: xīng fèn de bèng le qǐ lái
也会不断地变化: yě huì bù duàn de biàn huà
一声不吭地溜走: yī shēng bù kēng de liū zǒu
有多么地在乎你: yǒu duō me de zài hū nǐ
雨都是直直地下: yǔ dōu shì zhí zhí de xià
远远地抛到后边: yuǎn yuǎn de pāo dào hòu biān
在无声地变化着: zài wú shēng de biàn huà zhe
这样不停地叫着: zhè yàng bù tíng de jiào zhe
左一遍右一遍地: zuǒ yī biàn yòu yī biàn de
左一次右一次地: zuǒ yī cì yòu yī cì de
持续稳定地增长: chí xù wěn deng de zēng zhǎng
良心大大地坏了: liáng xīn dà dà de huài le
你会惊讶地发现: nǐ huì jīng yà de fā xiàn
偷偷地溜了出来: tōu tōu de liū le chū lái
可以非常简单地: kě yǐ fēi cháng jiǎn dān de
头也不回地离开: tóu yě bù huí de lí kāi
能够清晰地看到: néng gòu qīng xī de kàn dào
这样才能真正地: zhè yàng cái néng zhēn zhèng de
就可以很方便地: jiù kě yǐ hěn fāng biàn de
应该更多地放在: yīng gāi gèng duō de fàng zài
这样可以更好地: zhè yàng kě yǐ gèng hǎo de
可以痛痛快快地: kě yǐ tòng tòng kuài kuài de
可以舒舒服服地: kě yǐ shū shū fú fú de
可以自自然然地: kě yǐ zì zì rán rán de
可以安安静静地: kě yǐ ān ān jìng jìng de
一点一点地完善: yì diǎn yì diǎn de wán shàn
我以后会好好地: wǒ yǐ hòu huì hǎo hǎo de
我们就要好好地: wǒ men jiù yào hǎo hǎo de
我会毫不犹豫地: wǒ huì háo bù yóu yù de
很难准确地反映: hěn nán zhǔn què de fǎn yìng
静静地躺在床上: jìng jìng de tǎng zài chuáng shàng
狠狠地掐了一把: hěn hěn de qiā le yī bǎ
看起来是那样地: kàn qǐ lái shì nà yàng de
轻轻地摇了摇头: qīng qīng de yáo le yáo tóu
可以清楚地看见: kě yǐ qīng chǔ de kàn jiàn
自然而然地记住: zì rán ér rán de jì zhù
还在不断地进步: hái zài bù duàn de jìn bù
详细地说明一下: xiáng xì de shuō míng yī xià
只是为了更好地: zhǐ shì wèi le gèng hǎo de
这里能够清楚地: zhè lǐ néng gòu qīng chǔ de
可以简单地概括: kě yǐ jiǎn dān de gài kuò
或者是想当然地: huò zhě shì xiǎng dāng rán de
自己可以自由地: zì jǐ kě yǐ zì yóu de
平平静静地生活: píng píng jìng jìng de shēng huó
这样就能更快地: zhè yàng jiù néng gèng kuài de
这样就能更好地: zhè yàng jiù néng gèng hǎo de
不遗余力地宣传: bù yí yú lì de xuān chuán
不可能无限制地: bù kě néng wú xiàn zhì de
可以非常明确地: kě yǐ fēi cháng míng què de
也是为了更好地: yě shì wèi le gèng hǎo de
呆呆地看着自己: dāi dāi de kàn zhe zì jǐ
狠狠地亲了一下: hěn hěn de qīn le yī xià
静静地坐在那里: jìng jìng de zuò zài nà lǐ
从来没有好好地: cóng lái méi yǒu hǎo hǎo de
呆呆地坐在地上: dāi dāi de zuò zài de shàng
好好地休息一下: hǎo hǎo de xiū xī yī xià
乖乖地闭上了嘴: guāi guāi de bì shàng le zuǐ
为什么不好好地: wèi shén me bù hǎo hǎo de
简单地看了一下: jiǎn dān de kàn le yī xià
不能很好地实现: bù néng hěn hǎo de shí xiàn
轻轻地吻了一下: qīng qīng de wěn le yī xià
仅仅是习惯性地: jǐn jǐn shì xí guàn xìng de
才能最大限度地: cái néng zuì dà xiàn dù de
为了更好地改进: wèi le gèng hǎo de gǎi jìn
仔细地研究一下: zǐ xì de yán jiū yī xià
很不幸地碰上了: hěn bù xìng de pèng shàng le
认真地看了一下: rèn zhēn de kàn le yī xià
可以清晰地看到: kě yǐ qīng xī de kàn dào
可以清晰地看出: kě yǐ qīng xī de kàn chū
正清楚地反映了: zhèng qīng chǔ de fǎn yìng le
更好地完成任务: gèng hǎo de wán chéng rèn wù
下意识地避开了: xià yì shí de bì kāi le
狠狠地咬了一口: hěn hěn de yǎo le yī kǒu
最大限度地减少: zuì dà xiàn dù de jiǎn shǎo
有机地结合起来: yǒu jī de jié hé qǐ lái
也该好好地想想: yě gāi hǎo hǎo de xiǎng xiǎng
有点坏坏地笑道: yǒu diǎn huài huài de xiào dào
无所事事地过活: wú suǒ shì shì de guò huó
头也不回地走了: tóu yě bù huí de zǒu le
痛快地说出来吧: tòng kuài de shuō chū lái ba
气鼓鼓地不说话: qì gǔ gǔ de bù shuō huà
默默无闻地奉献: mò mò wú wén de fèng xiàn
结结巴巴地说出: jiē jiē bā bā de shuō chū
高质量地完成了: gāo zhì liàng de wán chéng le
缓慢而费力地前: huǎn màn ér fèi lì de qián
可以肯定地告诉你: kě yǐ kěn deng de gào sù nǐ
深深地吸了一口气: shēn shēn de xī le yì kǒu qì
我才深深地感觉到: wǒ cái shēn shēn de gǎn jué dào
可以清晰地感觉到: kě yǐ qīng xī de gǎn jué dào
只能眼巴巴地看着: zhǐ néng yǎn bā bā de kàn zhe
但我们不能简单地: dàn wǒ men bù néng jiǎn dān de
可以轻松地打出来: kě yǐ qīng sōng de dǎ chū lái
默默地流下了眼泪: mò mò de liú xià le yǎn lèi
只能眼睁睁地看着: zhǐ néng yǎn zhēng zhēng de kàn zhe
这也是为了更好地: zhè yě shì wèi le gèng hǎo de
深入持久地开展下: shēn rù chí jiǔ de kāi zhǎn xià
全神贯注地倾听着: quán shén guàn zhù de qīng tīng zhe
缓慢而费力地前进: huǎn màn ér fèi lì de qián jìn
事情要一点一点地做: shì qíng yào yì diǎn yì diǎn de zuò
一定要清醒地认识到: yí deng yào qīng xǐng de rèn shí dào
我可以明确地告诉你: wǒ kě yǐ míng què de gào sù nǐ
深入持久地开展下去: shēn rù chí jiǔ de kāi zhǎn xià qù
急促而不清楚地说出: jí cù ér bù qīng chǔ de shuō chū
全心全意地为人民服务: quán xīn quán yì de wéi rén mín fú wù
