# 新增或纠正的拼音数据
# 升级版本的时候会合并回 pinyin.txt
# 示例
地藏: dì zàng #包括一切 地藏xxx ，比如地藏寺、地藏王、地藏菩萨等等
斯事体大: sī shì tǐ dà
朝阳: zhāo yáng
朝阳_2: cháo yáng
还君明珠: huán jūn míng zhū
少东家: shào dōng jiā
少儿: shào ér
少先队: shào xiān duì
那些: nà xiē
那些_2: nèi xiē
枯萎: kū wěi
落魄: luò pò
九回肠: jiǔ huí cháng
仿徨失措: páng huáng shī cuò
关门闭户: guān mén bì hù
别无分店: bié wú fēn diàn
助画方略: zhù huà fāng lüè
卑谄足恭: bēi chǎn zú gōng
变古乱常: biàn gǔ luàn cháng
后不巴店: hòu bù bā diàn
唔使: wú shǐ
唔哚: wú duǒ
唔哩: wú lǐ
唔笃: wú dǔ
呒不: wǔ bù
呒啥: wǔ shá
呒没: wǔ méi
呒淘成: wǔ táo chéng
呒虾米输入法: wǔ xiā mǐ shū rù fǎ
失张失志: shī zhāng shī zhì
失张失致: shī zhāng shī zhì
学如不及: xué rú bù jí
学如登山: xué rú dēng shān
度人之心: duó rén zhī xīn
度人之腹: duó rén zhī fù
恶噷噷: è hěn hěn
断手续玉: duàn shóu xù yù
日居月诸: rì jū yuè zhū
本支百世: běn zhī bǎi shì
柳夭桃艳: liǔ yāo táo yàn
歌于斯: gē yú sī
毛茸茸: máo róng róng
水陆杂陈: shuǐ lù zá chén
清莹秀澈: qīng yíng xiù chè
火燵: huǒ tā
犬兔俱毙: quǎn tù jù bì
独清独醒: dú qīng dú xǐng
现世现报: xiàn shì xiàn bào
登木求鱼: dēng mù qiú yú
英雄辈出: yīng xióng bèi chū
败则为贼: bài zé wéi zéi
贵贱无二: guì jiàn wú èr
践规踏矩: jiàn guī tà jǔ
进德修业: jìn dé xiū yè
避毁就誉: bì huǐ jiù yù
避阱入坑: bì jǐng rù kēng
闭壁清野: bì bì qīng yě
陂艿: bēi rèng
陈师鞠旅: chén shī jū lǚ
雷霆之怒: léi tíng zhī nù
革面敛手: gé miàn liǎn shǒu
又细又长: yòu xì yòu cháng
五行生克: wǔ xíng shēng kè
甚么: shén me
甚麼: shén me
种下: zhòng xià
代数数: dài shù shù
又细又长: yòu xì yòu cháng
地藏寺: dì zàng sì
弹劾案: tán hé àn
数数: shǔ shù
朝日: zhāo rì
朝日关系: cháo rì guān xì
铺盖卷儿: pū gài juǎn er
便宜: pián yi
知了: zhī liǎo
太子参: tài zi shēn
一死了之: yī sǐ liǎo zhī
佛系: fó xì
称手: chèn shǒu
大城: dà chéng
大城市: dà chéng shì
分子: fèn zǐ
分子力: fēn zǐ lì
分子式: fēn zǐ shì
分子物理学: fēn zǐ wù lǐ xué
分子生物学: fēn zǐ shēng wù xué
分子生物學: fēn zǐ shēng wù xué
分子筛: fēn zǐ shāi
分子运动论: fēn zǐ yùn dòng lùn
分子量: fēn zǐ liàng
分子钟: fēn zǐ zhōng
高分子: gāo fēn zǐ
高分子功能材料: gāo fēn zǐ gōng néng cái liào
高分子化合物: gāo fēn zǐ huà hé wù
高分子化工: gāo fēn zǐ huà gōng
公分子: gōng fēn zǐ
克分子: kè fēn zǐ
分子晶体: fēn zǐ jīng tǐ
分子晶體: fēn zǐ jīng tǐ
分子结构: fēn zǐ jié gòu
分子結構: fēn zǐ jié gòu
超分子: chāo fēn zǐ
一分子甲烷: yī fēn zǐ jiǎ wán
极性分子: jí xìng fēn zǐ
極性分子: jí xìng fēn zǐ
分子和分母: fēn zǐ hé fēn mǔ
大行星: dà xíng xīng
九大行星: jiǔ dà xíng xīng
八大行星: bā dà xíng xīng
换行: huàn háng
漢藏: hàn zàng
援藏: yuán zàng
啜泣: chuò qì
乐亭: lào tíng
乐亭县: lào tíng xiàn
标识: biāo shí
目标: mù biāo
银行: yín háng
行长: háng zhǎng


一分子: yī fèn zǐ
一发: yī fā
一帆风顺: yī fān fēng shùn
一溜歪斜: yī liù wāi xié
一溜烟: yī liù yān
一溜风: yī liù fēng
一片散沙: yī piàn sǎn shā
一见了然: yī jiàn liǎo rán
万户侯: wàn hù hóu
三年五载: sān nián wǔ zǎi
三老四少: sān lǎo sì shào
上去: shàng qù
上当学乖: shàng dàng xué guāi
下调: xià tiáo
与世无争: yǔ shì wú zhēng
与世沉浮: yǔ shì chén fú
东家西舍: dōng jiā xī shè
丧家: sāng jiā
中都: zhōng dū
临了: lín liǎo
为国为民: wèi guó wèi mín
为着: wèi zhe
主少国疑: zhǔ shào guó yí
乌拉: wū lā
乌拉圭: wū la guī
乌拉尔山脉: wū la ěr shān mài
乌拉草: wū la cǎo
乍暖还寒: zhà nuǎn huán hán
乐善好义: lè shàn hào yì
乐子: lè zi
乐手: yuè shǒu
乐都: lè dū
乘壶: chéng hú
九大行星: jiǔ dà xíng xīng
乱发: luàn fà
乱哄哄: luàn hōng hōng
了然无闻: liǎo rán wú wén
了身脱命: liǎo shēn tuō mìng
亏累: kuī lěi
互见: hù jiàn
五侯七贵: wǔ hóu qī guì
五脊六兽: wǔ jǐ liù shòu
五藏六府: wǔ zàng liù fǔ
五行八作: wǔ háng bā zuō
亲家公: qìng jia gōng
亲家母: qìng jia mǔ
仿徨失措: fǎng huáng shī cuò
企划: qǐ huà
众啄同音: zhòng zhuó tóng yīn
传神阿堵: chuán shén ē dǔ
伪君子: wěi jūn zǐ
伯伯: bó bo
伺弄: sì nòng
作乐: zuò lè
作坊: zuō fang
作弄: zuò nòng
侄儿: zhí ér
侄女儿: zhí nǚ ér
供暖: gōng nuǎn
便血: biàn xiě
俏成俏败: qiào chéng qiào bài
倔头倔脑: juè tóu juè nǎo
倔犟: jué jiàng
倡优: chāng yōu
像模像样: xiàng mú xiàng yàng
免服: miǎn fú
免袒: miǎn tǎn
入土为安: rù tǔ wéi ān
公了: gōng liǎo
兴冲冲: xìng chōng chōng
冠名: guàn míng
出乖露丑: chū guāi lòu chǒu
出入将相: chū rù jiàng xiàng
出奇划策: chū qí huà cè
出血: chū xiě
刁钻促搯: diāo zuān cù tāo
刁钻促狭: diāo zuān cù xiá
分子: fēn zǐ
分子力: fēn zǐ lì
分子式: fēn zǐ shì
分子生物学: fēn zǐ shēng wù xué
分子筛: fēn zǐ shāi
分子量: fēn zǐ liàng
分散: fēn sàn
分散主义: fēn sàn zhǔ yì
切中要害: qiè zhòng yào hài
切分: qiē fēn
切勿: qiè wù
切当: qiè dàng
切身体会: qiè shēn tǐ huì
划子: huá zi
别嘴: biè zuǐ
刷子: shuā zi
刹时: chà shí
剀切: kǎi qiè
削面: xiāo miàn
力有未逮: lì yǒu wèi dài
功夫: gōng fu
动如参商: dòng rú shēn shāng
动画片: dòng huà piàn
劳什子: láo shí zi
势头: shì tou
勇将: yǒng jiàng
化为泡影: huà wéi pào yǐng
十夫楺椎: shí fū róu zhuī
千了百了: qiān liǎo bǎi liǎo
南乐: nán yuè
博得: bó dé
卷心菜: juǎn xīn cài
卷甲韬戈: juǎn jiǎ tāo gē
卷甲束兵: juǎn jiǎ shù bīng
卷甲衔枚: juǎn jiǎ xián méi
卷缩: juǎn suō
卷须: juǎn xū
厂子: chǎng zi
厚薄: hòu bó
原处: yuán chù
叉子: chā zi
反弹: fǎn tán
发网: fà wǎng
发胶: fà jiāo
取得: qǔ dé
取给: qǔ jǐ
口角: kǒu jiǎo
另当别论: lìng dāng bié lùn
只得: zhǐ dé
只见: zhǐ jiàn
叫化: jiào huā
可怜相: kě lián xiàng
台观: tái guān
号哭: háo kū
号子: hào zi
吁咈都俞: xū fú dū yú
吃哑巴亏: chī yǎ ba kuī
各尽其职: gè jìn qí zhí
名分: míng fèn
名刹: míng chà
呢子: ní zi
周正: zhōu zhèng
命相: mìng xiàng
咳血: ké xiě
哀的美敦书: āi dì měi dūn shū
哆哆嗦嗦: duō duō suō suō
哑子: yǎ zi
哑巴: yǎ ba
哑巴亏: yǎ ba kuī
哪个: nǎ ge
哪些: nǎ xiē
哪门子: nǎ mén zi
喀吧: kā bā
喜丧: xǐ sāng
嗣子: sì zǐ
器乐: qì yuè
嚷嚷: rāng rang
嚼子: jiáo zi
国乐: guó yuè
地堡: dì bǎo
地窨子: dì yìn zi
场屋: cháng wū
坏东西: huài dōng xi
垂头搨翼: chuí tóu tà yì
埠头: bù tóu
堂皇冠冕: táng huáng guān miǎn
塞上江南: sài shàng jiāng nán
塞擦音: sè cā yīn
填塞: tián sè
外相: wài xiàng
夜猫子: yè māo zi
够呛: gòu qiàng
够意思: gòu yì si
大吃大喝: dà chī dà hē
大姑子: dà gū zi
大姨子: dà yí zi
大换血: dà huàn xiě
大模大样: dà mú dà yàng
大王: dà wáng
大肚子: dà dù zi
大舅子: dà jiù zi
大行星: dà xíng xīng
大雅: dà yǎ
大黄: dà huáng
奔头: bèn tou
女强人: nǚ qiáng rén
女角: nǚ jué
好佚恶劳: hào yì wù láo
好吃好喝: hǎo chī hǎo hē
好善嫉恶: hào shàn jí è
好强: hǎo qiáng
好管闲事: hào guǎn xián shì
好自为之: hǎo zì wéi zhī
好高鹜远: hào gāo wù yuǎn
妙龄女子: miào líng nǚ zǐ
妻儿老少: qī ér lǎo shào
姥姥: lǎo lao
姨姥姥: yí lǎo lao
娘子: niáng zǐ
婆婆: pó po
嫡子: dí zǐ
孢子: bāo zǐ
守将: shǒu jiàng
宝贝疙瘩: bǎo bèi gē da
富商大贾: fù shāng dà gǔ
富商巨贾: fù shāng jù gǔ
富贾: fù gǔ
小意思: xiǎo yì si
小数点: xiǎo shù diǎn
小肚子: xiǎo dù zi
少商: shào shāng
少奶奶: shào nǎi nai
少帅: shào shuài
少林寺: shào lín sì
少林拳: shào lín quán
少男: shào nán
尤甚: yóu shèn
尥蹶子: liào juě zi
尺头: chǐ tou
尽可能: jǐn kě néng
尽着: jìn zhe
尽让: jǐn ràng
尾巴: wěi ba
尿血: niào xiě
屏声敛息: bǐng shēng liǎn xī
屏声静气: bǐng shēng jìng qì
屏气吞声: bǐng qì tūn shēng
屯子: tún zi
工夫: gōng fu
左撇子: zuǒ piě zi
差不多: chà bu duō
帖子: tiě zi
带累: dài lěi
干名犯义: gàn míng fàn yì
干咳: gān ké
干嘛: gàn má
干将莫邪: gān jiāng mò yé
干巴: gān ba
干白: gān bái
平铺: píng pū
平铺直序: píng pū zhí xù
年分: nián fèn
年谊世好: nián yì shì hǎo
应季: yìng jì
应得: yīng dé
应招: yìng zhāo
应选: yīng xuǎn
度人之腹: dù rén zhī fù
开豁: kāi huò
弄管调弦: nòng guǎn tiáo xián
引得: yǐn dé
弟弟: dì di
弹腿: tán tuǐ
当行本色: dāng háng běn sè
影片: yǐng piàn
役畜: yì chù
心惊胆颤: xīn jīng dǎn zhàn
心曲: xīn qū
心细如发: xīn xì rú fà
怎么着: zěn me zhe
悲号: bēi háo
悲咽: bēi yè
情凄意切: qíng qī yì qiè
惜客好义: xī kè hào yì
想得到: xiǎng de dào
意思: yì si
戏园子: xì yuán zi
戏子: xì zi
戏报子: xì bào zi
所得税: suǒ dé shuì
扎猛子: zhā měng zi
扎耳朵: zhā ěr duo
打家截舍: dǎ jiā jié shè
打摆子: dǎ bǎi zi
打转: dǎ zhuàn
承溜: chéng liū
抄没: chāo mò
把子: bǎ zi
抓工夫: zhuā gōng fu
折子: zhé zi
折子戏: zhé zi xì
折损: zhé sǔn
折腾: zhē teng
折衷: zhé zhōng
折辱: zhé rǔ
披发入山: pī fà rù shān
抹子: mǒ zi
抹煞: mǒ shā
抹脸: mǒ liǎn
抽丝剥茧: chōu sī bō jiǎn
抽空: chōu kòng
拉家常: lā jiā cháng
拉肚子: lā dù zi
招待会: zhāo dài huì
拜把子: bài bǎ zi
拶子: zǎn zi
拽布拖麻: zhuài bù tuō má
挂累: guà lěi
指缝: zhǐ fèng
挑嘴: tiāo zuǐ
挟势弄权: xié shì nòng quán
挡子: dǎng zi
捆扎: kǔn zā
换血: huàn xiě
掌掴: zhǎng guó
排子车: pǎi zi chē
掴手: guó shǒu
摧折: cuī zhé
撩蜂剔蝎: liáo fēng tī xiē
撰著: zhuàn zhù
攀花折柳: pān huā zhé liǔ
攻城掠地: gōng chéng lüè dì
攻心扼吭: gōng xīn è háng
放血: fàng xiě
放还: fàng huán
故伎重演: gù jì chóng yǎn
敛声屏息: liǎn shēng bǐng xī
散座: sǎn zuò
散户: sǎn hù
散言碎语: sǎn yán suì yǔ
数得上: shǔ de shàng
整冠纳履: zhěng guān nà lǚ
文过遂非: wén guò suì fēi
斗筲穿窬: dǒu shāo chuān yú
断发纹身: duàn fà wén shēn
旋干转坤: xuán qián zhuǎn kūn
无缝天衣: wú fèng tiān yī
日没: rì mò
旧事重提: jiù shì chóng tí
时行: shí xíng
是非曲直: shì fēi qū zhí
晃晃: huàng huàng
晃晃悠悠: huàng huàng yōu yōu
晕乎乎: yūn hū hū
暮四朝三: mù sì zhāo sān
暮想朝思: mù xiǎng zhāo sī
暮爨朝舂: mù cuàn zhāo chōng
暮翠朝红: mù cuì zhāo hóng
曲别针: qū bié zhēn
曲曲折折: qū qū zhé zhé
曲率: qū lǜ
曲面: qū miàn
曲颈甑: qū jǐng zèng
更名改姓: gēng míng gǎi xìng
月晕础润: yuè yùn chǔ rùn
有两下子: yǒu liǎng xià zi
有得: yǒu dé
有意思: yǒu yì si
望闻问切: wàng wén wèn qiè
望风而靡: wàng fēng ér mǐ
朝种暮获: zhāo zhòng mù huò
杆塔: gān tǎ
松筠之节: sōng yún zhī jié
果子露: guǒ zi lù
枝子: zhī zi
枝蔓: zhī màn
枭将: xiāo jiàng
架得住: jià de zhù
柞木: zuò mù
柞树: zuò shù
柳子戏: liǔ zi xì
栅子: zhà zi
校本: jiào běn
楞伽: léng qié
榫头: sǔn tou
槁项没齿: gǎo xiàng mò chǐ
槟子: bīn zi
模子: mú zi
橡皮图章: xiàng pí tú zhāng
款曲: kuǎn qū
歌仔戏: gē zǐ xì
武行: wǔ háng
死对头: sǐ duì tou
毛发倒竖: máo fà dǎo shù
毛发悚然: máo fà sǒng rán
毛发悚然: máo fà sǒng rán
毛发耸然: máo fà sǒng rán
氧吧: yǎng bā
水宿山行: shuǐ sù shān xíng
水宿风餐: shuǐ sù fēng cān
水磨工夫: shuǐ mó gōng fu
汉堡包: hàn bǎo bāo
沙拉: shā lā
没世无闻: mò shì wú wén
没世穷年: mò shì qióng nián
没世不渝: mò shì bù yú
没世无称: mò shì wú chēng
没意思: méi yì si
河南坠子: hé nán zhuì zi
法相: fǎ xiàng
波罗的海: bō luó dì hǎi
洒扫应对: sǎ sǎo yìng duì
活剥生吞: huó bō shēng tūn
浅浅: qiǎn qiǎn
浇头: jiāo tóu
浑水摸鱼: hún shuǐ mō yú
浓装艳抹: nóng zhuāng yàn mǒ
海德堡大学: hǎi dé bǎo dà xué
混浊: hùn zhuó
溜子: liū zi
滴答: dī dā
漫卷: màn juǎn
澄汰: chéng tài
灰蒙蒙: huī méng méng
炮筒子: pào tǒng zi
烟卷: yān juǎn
熏透: xūn tòu
燕麦: yàn mài
燕麦粥: yàn mài zhōu
爪子: zhuǎ zi
片头: piàn tóu
牵强附会: qiān qiǎng fù huì
牵强附合: qiān qiǎng fù hé
牵羊担酒: qiān yáng dān jiǔ
独有千秋: dú yǒu qiān qiū
狮子大开口: shī zi dà kāi kǒu
献血: xiàn xiě
王相: wáng xiàng
琢磨: zhuó mó
瑕瑜互见: xiá yú hù jiàn
瓜葛相连: guā gé xiāng lián
生拖死拽: shēng tuō sǐ zhuài
生闷气: shēng mèn qì
电子出版物: diàn zǐ chū bǎn wù
电子图书: diàn zǐ tú shū
电子汇款: diàn zǐ huì kuǎn
电子垃圾: diàn zǐ lā jī
电子玩具: diàn zǐ wán jù
电子词典: diàn zǐ cí diǎn
电磨: diàn mó
甸子: diàn zi
画片: huà piàn
画片儿: huà piàn er
留尾巴: liú wěi ba
畚斗: běn dǒu
畜生: chù sheng
疙瘩: gē da
疙瘩汤: gē da tāng
疙里疙瘩: gē lǐ gē da
痱子: fèi zi
瘠薄: jí bó
瘾君子: yǐn jūn zǐ
癞蛤蟆: lài há ma
癞蛤蟆想吃天鹅肉: lài há ma xiǎng chī tiān é ròu
登场: dēng cháng
白晃晃: bái huǎng huǎng
百日咳: bǎi rì ké
盖头: gài tou
目瞪舌彊: mù dèng shé jiāng
相书: xiàng shū
相扑: xiāng pū
相术: xiàng shù
相机行事: xiàng jī xíng shì
看财奴: kān cái nú
看青: kān qīng
真相毕露: zhēn xiàng bì lù
睡懒觉: shuì lǎn jiào
石担: shí dàn
破家为国: pò jiā wèi guó
破镜重合: pò jìng chóng hé
碑拓: bēi tà
碘酊: diǎn dīng
碰头会: pèng tóu huì
碰钉子: pèng dīng zi
碾场: niǎn cháng
磨房: mò fáng
神兵天将: shén bīng tiān jiàng
神曲: shén qǔ
祸福相倚: huò fú xiāng yǐ
禁子: jìn zi
禁用: jìn yòng
福将: fú jiàng
秀发: xiù fà
私了: sī liǎo
秃发: tū fà
种牛: zhǒng niú
种草: zhòng cǎo
科教片: kē jiào piàn
空位: kòng wèi
空格: kòng gé
穿着打扮: chuān zhuó dǎ bàn
第一信号系统: dì yī xìn hào xì tǒng
箕斗: jī dǒu
算得: suàn dé
簿子: bù zi
粉雕玉琢: fěn diāo yù zhuó
紫阳观: zǐ yáng guān
累加: lěi jiā
絮叨: xù dāo
红参: hóng shēn
纪传体: jì zhuàn tǐ
结巴: jiē ba
给与: jǐ yǔ
给付: jǐ fù
络腮胡子: luò sāi hú zi
绷子: bēng zi
编校: biān jiào
缝线: féng xiàn
缝缝连连: féng féng lián lián
美男子: měi nán zǐ
翘尾巴: qiào wěi ba
翻肠倒肚: fān cháng dǎo dù
老区: lǎo qū
老婆婆: lǎo pó po
老疙瘩: lǎo gē da
老调重弹: lǎo diào chóng tán
耙子: pá zi
耻与哙伍: chǐ yǔ kuài wǔ
聱牙诘屈: áo yá jié qū
股分: gǔ fèn
肤皮潦草: fū pí liáo cǎo
肩摩毂接: jiān mó gǔ jiē
背搭子: bèi dā zi
胶着: jiāo zhuó
腰杆子: yāo gǎn zi
腿肚子: tuǐ dù zi
膏子: gāo zi
膏泽: gāo zé
膻味: shān wèi
臊子: sào zi
自分: zì fèn
舂容大雅: chōng róng dà yǎ
舍得: shě de
舒卷: shū juǎn
良贾深藏: liáng gǔ shēn cáng
节假: jié jià
芥蓝: jiè lán
花岗石: huā gāng shí
苏州码子: sū zhōu mǎ zi
苗头: miáo tou
苦相: kǔ xiàng
英雄传: yīng xióng zhuàn
茜草: qiàn cǎo
草甸子: cǎo diàn zi
荷载: hè zài
落子: lào zi
葛屦履霜: gé jù lǚ shuāng
蒙蒙亮: mēng mēng liàng
蒙骗: mēng piàn
蓄发: xù fà
蔽塞: bì sè
薄情无义: bó qíng wú yì
薄葬: bó zàng
薄面: bó miàn
藏踪蹑迹: cáng zōng niè jì
藏香: zàng xiāng
虚晃一枪: xū huǎng yī qiāng
蛤蟆: há ma
蛤蟆镜: há ma jìng
蝍蛆: jí qū
行东: háng dōng
行商: xíng shāng
行家: háng jia
行栈: háng zhàn
行道树: xíng dào shù
衒玉贾石: xuàn yù gǔ shí
衣冠: yī guān
衣冠冢: yī guān zhǒng
表徵: biǎo zhēng
表蒙子: biǎo méng zi
衰衣: shuāi yī
衷曲: zhōng qū
要好: yào hǎo
要子: yào zi
要约: yāo yuē
覆盆子: fù pén zǐ
见世面: jiàn shì miàn
见得: jiàn dé
解衣衣人: jiě yī yī rén
解铃系铃: jiě líng xì líng
解铃还需系铃人: jiě líng hái xū xì líng rén
謷牙诘屈: áo yá jié qū
诃子: hē zǐ
识记: shí jì
诘屈謷牙: jié qū áo yá
说项: shuō xiàng
调人: tiáo rén
调拨: diào bō
调正: tiáo zhèng
调经: tiáo jīng
豁子: huō zi
豪商巨贾: háo shāng jù gǔ
貌相: mào xiàng
贪生恶死: tān shēng wù sǐ
购得: gòu dé
贵处: guì chù
赛璐玢: sài lù fēn
赢得: yíng dé
走为上着: zǒu wéi shàng zhāo
赶得上: gǎn de shàng
赶浪头: gǎn làng tou
赶鸭子上架: gǎn yā zi shàng jià
跑码头: pǎo mǎ tou
踝子骨: huái zi gǔ
蹄间三寻: tí jiān sān xún
蹑蹻担簦: niè jué dān dēng
身先朝露: shēn xiān zhāo lù
车行: chē háng
车行道: chē xíng dào
轧场: yà cháng
转动: zhuǎn dòng
转盘: zhuàn pán
转轴: zhuàn zhóu
轴子: zhóu zi
轻傜薄赋: qīng yáo bó fù
轻口薄舌: qīng kǒu bó shé
轻财好施: qīng cái hào shī
辟除: pì chú
过当: guò dàng
过得去: guò de qù
还情: huán qíng
还报: huán bào
这个: zhè ge
这么着: zhè me zhe
连更星夜: lián gēng xīng yè
连更彻夜: lián gēng chè yè
连更晓夜: lián gēng xiǎo yè
送丧: sòng sāng
送还: sòng huán
逗闷子: dòu mèn zi
通红: tōng hóng
遂心应手: suì xīn yìng shǒu
那个: nà ge
那么着: nà me zhe
邯郸重步: hán dān zhòng bù
都会: dū huì
采血: cǎi xiě
重作冯妇: chóng zuò féng fù
重头戏: zhòng tóu xì
重张: chóng zhāng
重纸累札: chóng zhǐ lěi zhá
重读: chóng dú
重迭: chóng dié
重选: chóng xuǎn
重金兼紫: zhòng jīn jiān zǐ
金晃晃: jīn huǎng huǎng
钉牢: dìng láo
钻木取火: zuān mù qǔ huǒ
钻牛角: zuān niú jiǎo
铺子: pù zi
铺面: pù miàn
铺面房: pù miàn fáng
门将: mén jiàng
间奏曲: jiān zòu qǔ
间杂: jiàn zá
闷头: mēn tóu
闷子车: mèn zi chē
闷雷: mèn léi
闹哄哄: nào hōng hōng
闹肚子: nào dù zi
防卫过当: fáng wèi guò dàng
阿家阿翁: ā jiā ā wēng
除丧: chú sāng
隽语: juàn yǔ
难得: nán dé
露头: lòu tóu
面相: miàn xiàng
韬戈卷甲: tāo gē juǎn jiǎ
颠仆流离: diān pū liú lí
颠衣到裳: diān yī dào cháng
风土人情: fēng tǔ rén qíng
飞将军: fēi jiāng jūn
食相: shí xiàng
饮冰食蘖: yǐn bīng shí niè
饮马长江: yìn mǎ cháng jiāng
饶头: ráo tou
首足异处: shǒu zú yì chù
马尾松: mǎ wěi sōng
马尾藻: mǎ wěi zǎo
马尾辫: mǎ wěi biàn
骨头: gǔ tou
骰子: tóu zi
高分子化合物: gāo fēn zǐ huà hé wù
高知: gāo zhī
高高兴兴: gāo gāo xìng xìng
鬈曲: quán qū
鬼哭神号: guǐ kū shén háo
鬼头: guǐ tóu
魏阙: wèi què
鱼肚白: yú dù bái
鲜廉寡耻: xiǎn lián guǎ chǐ
鸡内金: jī nèi jīn
鸡皮疙瘩: jī pí gē da
鸡肤鹤发: jī fū hè fà
鸣鹤之应: míng hè zhī yìng
鸿商富贾: hóng shāng fù gǔ
鸿衣羽裳: hóng yī yǔ cháng
黏皮着骨: nián pí zhuó gǔ
黏着: nián zhuó
黑发: hēi fà
鼻塞: bí sè
上卷: shàng juàn
九转功成: jiǔ zhuǎn gōng chéng
九重: jiǔ chóng
何处: hé chù
冠子: guān zi
出头露面: chū tóu lòu miàn
前爪: qián zhǎo
卿大夫: qīng dà fū
君子: jūn zǐ
君子好逑: jūn zǐ hǎo qiú
吹竹弹丝: chuī zhú tán sī
塞上: sài shàng
处处: chù chù
大将军: dà jiāng jūn
天台: tiān tái
好意思: hǎo yì si
如登春台: rú dēng chūn tái
娉婷婀娜: pīng tíng ē nuó
少林: shào lín
尽显: jìn xiǎn
屏迹: bǐng jì
山重水复: shān chóng shuǐ fù
扎破: zhā pò
打肿脸充胖子: dǎ zhǒng liǎn chōng pàng zi
打谷场: dǎ gǔ cháng
抵得上: dǐ de shàng
抹墙: mò qiáng
拧紧: nǐng jǐn
撒落: sǎ luò
是非只为多开口: shì fēi zhǐ wèi duō kāi kǒu
暮去朝来: mù qù zhāo lái
曲水流觞: qū shuǐ liú shāng
毛遂自荐: máo suì zì jiàn
汤婆子: tāng pó zi
溥天率土: pǔ tiān shuài tǔ
牛圈: niú juàn
省墓: xǐng mù
短发: duǎn fà
石磨: shí mò
竹篮打水一场空: zhú lán dǎ shuǐ yī cháng kōng
老伯伯: lǎo bó bo
脱壳: tuō ké
趵突泉: bào tū quán
都俞吁咈: dū yú xū fú
金石为开: jīn shí wéi kāi
难割难舍: nán gē nán shě
风磨: fēng mò
